Wojewodztwo,Powiat,Gminy,Symbol terytorialny,Ogolem,Miasto,Wies
Wojewodztwo Dolnośląskie,Powiat bolesławiecki,M.Bolesławiec,0201011,40209,40209,0
Wojewodztwo Dolnośląskie,Powiat bolesławiecki,G.Bolesławiec,0201022,13594,0,13594
Wojewodztwo Dolnośląskie,Powiat bolesławiecki,G.Gromadka,0201032,5523,0,5523
Wojewodztwo Dolnośląskie,Powiat bolesławiecki,M-W.Nowogrodziec,0201043,15232,4221,11011
Wojewodztwo Dolnośląskie,Powiat bolesławiecki,G.Osiecznica,0201052,7585,0,7585
Wojewodztwo Dolnośląskie,Powiat bolesławiecki,G.Warta Bolesławiecka,0201062,8327,0,8327
Wojewodztwo Dolnośląskie,Powiat dzierżoniowski,M.Bielawa,0202011,31699,31699,0
Wojewodztwo Dolnośląskie,Powiat dzierżoniowski,M.Dzierżoniów,0202021,34952,34952,0
Wojewodztwo Dolnośląskie,Powiat dzierżoniowski,M.Pieszyce,0202031,9689,9689,0
Wojewodztwo Dolnośląskie,Powiat dzierżoniowski,M.Piława Górna,0202041,6805,6805,0
Wojewodztwo Dolnośląskie,Powiat dzierżoniowski,G.Dzierżoniów,0202052,9396,0,9396
Wojewodztwo Dolnośląskie,Powiat dzierżoniowski,G.Łagiewniki,0202062,7592,0,7592
Wojewodztwo Dolnośląskie,Powiat dzierżoniowski,M-W.Niemcza,0202073,5886,3145,2741
Wojewodztwo Dolnośląskie,Powiat głogowski,M.Głogów,0203011,69608,69608,0
Wojewodztwo Dolnośląskie,Powiat głogowski,G.Głogów,0203022,6223,0,6223
Wojewodztwo Dolnośląskie,Powiat głogowski,G.Jerzmanowa,0203032,4185,0,4185
Wojewodztwo Dolnośląskie,Powiat głogowski,G.Kotla,0203042,4315,0,4315
Wojewodztwo Dolnośląskie,Powiat głogowski,G.Pęcław,0203052,2363,0,2363
Wojewodztwo Dolnośląskie,Powiat głogowski,G.Żukowice,0203062,3619,0,3619
Wojewodztwo Dolnośląskie,Powiat górowski,M-W.Góra,0204013,20963,12575,8388
Wojewodztwo Dolnośląskie,Powiat górowski,G.Jemielno,0204022,3174,0,3174
Wojewodztwo Dolnośląskie,Powiat górowski,G.Niechlów,0204032,5182,0,5182
Wojewodztwo Dolnośląskie,Powiat górowski,M-W.Wąsosz,0204043,7498,2797,4701
Wojewodztwo Dolnośląskie,Powiat jaworski,M.Jawor,0205011,24340,24340,0
Wojewodztwo Dolnośląskie,Powiat jaworski,M-W.Bolków,0205023,11162,5505,5657
Wojewodztwo Dolnośląskie,Powiat jaworski,G.Męcinka,0205032,4953,0,4953
Wojewodztwo Dolnośląskie,Powiat jaworski,G.Mściwojów,0205042,4206,0,4206
Wojewodztwo Dolnośląskie,Powiat jaworski,G.Paszowice,0205052,3978,0,3978
Wojewodztwo Dolnośląskie,Powiat jaworski,G.Wądroże Wielkie,0205062,4095,0,4095
Wojewodztwo Dolnośląskie,Powiat jeleniogórski,M.Karpacz,0206011,5026,5026,0
Wojewodztwo Dolnośląskie,Powiat jeleniogórski,M.Kowary,0206021,11784,11784,0
Wojewodztwo Dolnośląskie,Powiat jeleniogórski,M.Piechowice,0206031,6565,6565,0
Wojewodztwo Dolnośląskie,Powiat jeleniogórski,M.Szklarska Poręba,0206041,7002,7002,0
Wojewodztwo Dolnośląskie,Powiat jeleniogórski,G.Janowice Wielkie,0206052,4276,0,4276
Wojewodztwo Dolnośląskie,Powiat jeleniogórski,G.Jeżów Sudecki,0206062,6777,0,6777
Wojewodztwo Dolnośląskie,Powiat jeleniogórski,G.Mysłakowice,0206072,10197,0,10197
Wojewodztwo Dolnośląskie,Powiat jeleniogórski,G.Podgórzyn,0206082,8120,0,8120
Wojewodztwo Dolnośląskie,Powiat jeleniogórski,G.Stara Kamienica,0206092,5387,0,5387
Wojewodztwo Dolnośląskie,Powiat kamiennogórski,M.Kamienna Góra,0207011,20734,20734,0
Wojewodztwo Dolnośląskie,Powiat kamiennogórski,G.Kamienna Góra,0207022,8910,0,8910
Wojewodztwo Dolnośląskie,Powiat kamiennogórski,M-W.Lubawka,0207033,11602,6448,5154
Wojewodztwo Dolnośląskie,Powiat kamiennogórski,G.Marciszów,0207042,4713,0,4713
Wojewodztwo Dolnośląskie,Powiat kłodzki,M.Duszniki-Zdrój,0208011,5029,5029,0
Wojewodztwo Dolnośląskie,Powiat kłodzki,M.Kłodzko,0208021,28750,28750,0
Wojewodztwo Dolnośląskie,Powiat kłodzki,M.Kudowa-Zdrój,0208031,10429,10429,0
Wojewodztwo Dolnośląskie,Powiat kłodzki,M.Nowa Ruda,0208041,23896,23896,0
Wojewodztwo Dolnośląskie,Powiat kłodzki,M.Polanica-Zdrój,0208051,6799,6799,0
Wojewodztwo Dolnośląskie,Powiat kłodzki,M-W.Bystrzyca Kłodzka,0208063,19823,10652,9171
Wojewodztwo Dolnośląskie,Powiat kłodzki,G.Kłodzko,0208072,17228,0,17228
Wojewodztwo Dolnośląskie,Powiat kłodzki,M-W.Lądek-Zdrój,0208083,8820,6091,2729
Wojewodztwo Dolnośląskie,Powiat kłodzki,G.Lewin Kłodzki,0208092,1983,0,1983
Wojewodztwo Dolnośląskie,Powiat kłodzki,M-W.Międzylesie,0208103,7594,2755,4839
Wojewodztwo Dolnośląskie,Powiat kłodzki,G.Nowa Ruda,0208112,12272,0,12272
Wojewodztwo Dolnośląskie,Powiat kłodzki,M-W.Radków,0208123,9460,2521,6939
Wojewodztwo Dolnośląskie,Powiat kłodzki,M-W.Stronie Śląskie,0208133,7833,6086,1747
Wojewodztwo Dolnośląskie,Powiat kłodzki,M-W.Szczytna,0208143,7477,5344,2133
Wojewodztwo Dolnośląskie,Powiat legnicki,M.Chojnów,0209011,14367,14367,0
Wojewodztwo Dolnośląskie,Powiat legnicki,G.Chojnów,0209022,9466,0,9466
Wojewodztwo Dolnośląskie,Powiat legnicki,G.Krotoszyce,0209032,3182,0,3182
Wojewodztwo Dolnośląskie,Powiat legnicki,G.Kunice,0209042,5903,0,5903
Wojewodztwo Dolnośląskie,Powiat legnicki,G.Legnickie Pole,0209052,5127,0,5127
Wojewodztwo Dolnośląskie,Powiat legnicki,G.Miłkowice,0209062,6290,0,6290
Wojewodztwo Dolnośląskie,Powiat legnicki,M-W.Prochowice,0209073,7566,3704,3862
Wojewodztwo Dolnośląskie,Powiat legnicki,G.Ruja,0209082,2726,0,2726
Wojewodztwo Dolnośląskie,Powiat lubański,M.Lubań,0210011,22301,22301,0
Wojewodztwo Dolnośląskie,Powiat lubański,M.Świeradów-Zdrój,0210021,4498,4498,0
Wojewodztwo Dolnośląskie,Powiat lubański,M-W.Leśna,0210033,10565,4686,5879
Wojewodztwo Dolnośląskie,Powiat lubański,G.Lubań,0210042,6515,0,6515
Wojewodztwo Dolnośląskie,Powiat lubański,M-W.Olszyna,0210053,6707,4527,2180
Wojewodztwo Dolnośląskie,Powiat lubański,G.Platerówka,0210062,1665,0,1665
Wojewodztwo Dolnośląskie,Powiat lubański,G.Siekierczyn,0210072,4609,0,4609
Wojewodztwo Dolnośląskie,Powiat lubiński,M.Lubin,0211011,75357,75357,0
Wojewodztwo Dolnośląskie,Powiat lubiński,G.Lubin,0211022,13448,0,13448
Wojewodztwo Dolnośląskie,Powiat lubiński,G.Rudna,0211032,7548,0,7548
Wojewodztwo Dolnośląskie,Powiat lubiński,M-W.Ścinawa,0211043,10520,5936,4584
Wojewodztwo Dolnośląskie,Powiat lwówecki,M-W.Gryfów Śląski,0212013,10249,7096,3153
Wojewodztwo Dolnośląskie,Powiat lwówecki,M-W.Lubomierz,0212023,6212,2026,4186
Wojewodztwo Dolnośląskie,Powiat lwówecki,M-W.Lwówek Śląski,0212033,18097,9462,8635
Wojewodztwo Dolnośląskie,Powiat lwówecki,M-W.Mirsk,0212043,9008,4199,4809
Wojewodztwo Dolnośląskie,Powiat lwówecki,M-W.Wleń,0212053,4453,1855,2598
Wojewodztwo Dolnośląskie,Powiat milicki,G.Cieszków,0213012,4714,0,4714
Wojewodztwo Dolnośląskie,Powiat milicki,G.Krośnice,0213022,8227,0,8227
Wojewodztwo Dolnośląskie,Powiat milicki,M-W.Milicz,0213033,24565,11964,12601
Wojewodztwo Dolnośląskie,Powiat oleśnicki,M.Oleśnica,0214011,37118,37118,0
Wojewodztwo Dolnośląskie,Powiat oleśnicki,M-W.Bierutów,0214023,10292,5084,5208
Wojewodztwo Dolnośląskie,Powiat oleśnicki,G.Dobroszyce,0214032,6336,0,6336
Wojewodztwo Dolnośląskie,Powiat oleśnicki,G.Dziadowa Kłoda,0214042,4617,0,4617
Wojewodztwo Dolnośląskie,Powiat oleśnicki,M-W.Międzybórz,0214053,5125,2386,2739
Wojewodztwo Dolnośląskie,Powiat oleśnicki,G.Oleśnica,0214062,12342,0,12342
Wojewodztwo Dolnośląskie,Powiat oleśnicki,M-W.Syców,0214073,16456,10469,5987
Wojewodztwo Dolnośląskie,Powiat oleśnicki,M-W.Twardogóra,0214083,13023,6847,6176
Wojewodztwo Dolnośląskie,Powiat oławski,M.Oława,0215011,31847,31847,0
Wojewodztwo Dolnośląskie,Powiat oławski,G.Domaniów,0215022,5372,0,5372
Wojewodztwo Dolnośląskie,Powiat oławski,M-W.Jelcz-Laskowice,0215033,22828,15833,6995
Wojewodztwo Dolnośląskie,Powiat oławski,G.Oława,0215042,14753,0,14753
Wojewodztwo Dolnośląskie,Powiat polkowicki,M-W.Chocianów,0216013,13088,8293,4795
Wojewodztwo Dolnośląskie,Powiat polkowicki,G.Gaworzyce,0216022,3930,0,3930
Wojewodztwo Dolnośląskie,Powiat polkowicki,G.Grębocice,0216032,5300,0,5300
Wojewodztwo Dolnośląskie,Powiat polkowicki,M-W.Polkowice,0216043,27163,22802,4361
Wojewodztwo Dolnośląskie,Powiat polkowicki,M-W.Przemków,0216053,8868,6549,2319
Wojewodztwo Dolnośląskie,Powiat polkowicki,G.Radwanice,0216062,4628,0,4628
Wojewodztwo Dolnośląskie,Powiat strzeliński,G.Borów,0217012,5270,0,5270
Wojewodztwo Dolnośląskie,Powiat strzeliński,G.Kondratowice,0217022,4594,0,4594
Wojewodztwo Dolnośląskie,Powiat strzeliński,G.Przeworno,0217032,5122,0,5122
Wojewodztwo Dolnośląskie,Powiat strzeliński,M-W.Strzelin,0217043,22216,12608,9608
Wojewodztwo Dolnośląskie,Powiat strzeliński,M-W.Wiązów,0217053,7518,2380,5138
Wojewodztwo Dolnośląskie,Powiat średzki,G.Kostomłoty,0218012,7160,0,7160
Wojewodztwo Dolnośląskie,Powiat średzki,G.Malczyce,0218022,6100,0,6100
Wojewodztwo Dolnośląskie,Powiat średzki,G.Miękinia,0218032,13338,0,13338
Wojewodztwo Dolnośląskie,Powiat średzki,M-W.Środa Śląska,0218043,19512,9225,10287
Wojewodztwo Dolnośląskie,Powiat średzki,G.Udanin,0218052,5486,0,5486
Wojewodztwo Dolnośląskie,Powiat świdnicki,M.Świdnica,0219011,60437,60437,0
Wojewodztwo Dolnośląskie,Powiat świdnicki,M.Świebodzice,0219021,23292,23292,0
Wojewodztwo Dolnośląskie,Powiat świdnicki,G.Dobromierz,0219032,5418,0,5418
Wojewodztwo Dolnośląskie,Powiat świdnicki,M-W.Jaworzyna Śląska,0219043,10413,5258,5155
Wojewodztwo Dolnośląskie,Powiat świdnicki,G.Marcinowice,0219052,6499,0,6499
Wojewodztwo Dolnośląskie,Powiat świdnicki,M-W.Strzegom,0219063,27106,16963,10143
Wojewodztwo Dolnośląskie,Powiat świdnicki,G.Świdnica,0219072,16374,0,16374
Wojewodztwo Dolnośląskie,Powiat świdnicki,M-W.Żarów,0219083,12646,7000,5646
Wojewodztwo Dolnośląskie,Powiat trzebnicki,M-W.Oborniki Śląskie,0220013,19190,8826,10364
Wojewodztwo Dolnośląskie,Powiat trzebnicki,M-W.Prusice,0220023,9370,2302,7068
Wojewodztwo Dolnośląskie,Powiat trzebnicki,M-W.Trzebnica,0220033,22969,12619,10350
Wojewodztwo Dolnośląskie,Powiat trzebnicki,G.Wisznia Mała,0220042,9319,0,9319
Wojewodztwo Dolnośląskie,Powiat trzebnicki,G.Zawonia,0220052,5697,0,5697
Wojewodztwo Dolnośląskie,Powiat trzebnicki,M-W.Żmigród,0220063,15041,6573,8468
Wojewodztwo Dolnośląskie,Powiat wałbrzyski,M.Boguszów-Gorce,0221011,16590,16590,0
Wojewodztwo Dolnośląskie,Powiat wałbrzyski,M.Jedlina-Zdrój,0221021,5082,5082,0
Wojewodztwo Dolnośląskie,Powiat wałbrzyski,M.Szczawno-Zdrój,0221031,5926,5926,0
Wojewodztwo Dolnośląskie,Powiat wałbrzyski,G.Czarny Bór,0221042,4841,0,4841
Wojewodztwo Dolnośląskie,Powiat wałbrzyski,M-W.Głuszyca,0221053,9176,6872,2304
Wojewodztwo Dolnośląskie,Powiat wałbrzyski,M-W.Mieroszów,0221063,7377,4486,2891
Wojewodztwo Dolnośląskie,Powiat wałbrzyski,G.Stare Bogaczowice,0221072,4253,0,4253
Wojewodztwo Dolnośląskie,Powiat wałbrzyski,G.Walim,0221082,5752,0,5752
Wojewodztwo Dolnośląskie,Powiat wałbrzyski,M.Wałbrzych,0221091,120715,120715,0
Wojewodztwo Dolnośląskie,Powiat wołowski,M-W.Brzeg Dolny,0222013,16266,12739,3527
Wojewodztwo Dolnośląskie,Powiat wołowski,G.Wińsko,0222022,8677,0,8677
Wojewodztwo Dolnośląskie,Powiat wołowski,M-W.Wołów,0222033,22930,12597,10333
Wojewodztwo Dolnośląskie,Powiat wrocławski,G.Czernica,0223012,11820,0,11820
Wojewodztwo Dolnośląskie,Powiat wrocławski,G.Długołęka,0223022,24152,0,24152
Wojewodztwo Dolnośląskie,Powiat wrocławski,G.Jordanów Śląski,0223032,3113,0,3113
Wojewodztwo Dolnośląskie,Powiat wrocławski,M-W.Kąty Wrocławskie,0223043,21144,6032,15112
Wojewodztwo Dolnośląskie,Powiat wrocławski,G.Kobierzyce,0223052,16912,0,16912
Wojewodztwo Dolnośląskie,Powiat wrocławski,G.Mietków,0223062,3838,0,3838
Wojewodztwo Dolnośląskie,Powiat wrocławski,M-W.Sobótka,0223073,12728,7023,5705
Wojewodztwo Dolnośląskie,Powiat wrocławski,M-W.Siechnice,0223083,16391,5376,11015
Wojewodztwo Dolnośląskie,Powiat wrocławski,G.Żórawina,0223092,9267,0,9267
Wojewodztwo Dolnośląskie,Powiat ząbkowicki,M-W.Bardo,0224013,5559,2794,2765
Wojewodztwo Dolnośląskie,Powiat ząbkowicki,G.Ciepłowody,0224022,3136,0,3136
Wojewodztwo Dolnośląskie,Powiat ząbkowicki,G.Kamieniec Ząbkowicki,0224032,8610,0,8610
Wojewodztwo Dolnośląskie,Powiat ząbkowicki,G.Stoszowice,0224042,5547,0,5547
Wojewodztwo Dolnośląskie,Powiat ząbkowicki,M-W.Ząbkowice Śląskie,0224053,23099,16086,7013
Wojewodztwo Dolnośląskie,Powiat ząbkowicki,M-W.Ziębice,0224063,18215,9308,8907
Wojewodztwo Dolnośląskie,Powiat ząbkowicki,M-W.Złoty Stok,0224073,4827,3004,1823
Wojewodztwo Dolnośląskie,Powiat zgorzelecki,M.Zawidów,0225011,4384,4384,0
Wojewodztwo Dolnośląskie,Powiat zgorzelecki,M.Zgorzelec,0225021,32525,32525,0
Wojewodztwo Dolnośląskie,Powiat zgorzelecki,M-W.Bogatynia,0225033,25009,18894,6115
Wojewodztwo Dolnośląskie,Powiat zgorzelecki,M-W.Pieńsk,0225043,9361,5961,3400
Wojewodztwo Dolnośląskie,Powiat zgorzelecki,G.Sulików,0225052,6150,0,6150
Wojewodztwo Dolnośląskie,Powiat zgorzelecki,M-W.Węgliniec,0225063,8841,3090,5751
Wojewodztwo Dolnośląskie,Powiat zgorzelecki,G.Zgorzelec,0225072,8227,0,8227
Wojewodztwo Dolnośląskie,Powiat złotoryjski,M.Wojcieszów,0226011,3913,3913,0
Wojewodztwo Dolnośląskie,Powiat złotoryjski,M.Złotoryja,0226021,16539,16539,0
Wojewodztwo Dolnośląskie,Powiat złotoryjski,G.Pielgrzymka,0226032,4697,0,4697
Wojewodztwo Dolnośląskie,Powiat złotoryjski,M-W.Świerzawa,0226043,7816,2428,5388
Wojewodztwo Dolnośląskie,Powiat złotoryjski,G.Zagrodno,0226052,5590,0,5590
Wojewodztwo Dolnośląskie,Powiat złotoryjski,G.Złotoryja,0226062,7117,0,7117
Wojewodztwo Dolnośląskie,Powiat złotoryjski,m. Jelenia Góra,0261,83860,83860,0
Wojewodztwo Dolnośląskie,Powiat złotoryjski,m. Legnica,0262,103238,103238,0
Wojewodztwo Dolnośląskie,Powiat złotoryjski,m. Wrocław,0264,630131,630131,0
Wojewodztwo Kujawsko-pomorskie,Powiat aleksandrowski,M.Aleksandrów Kujawski,0401011,12614,12614,0
Wojewodztwo Kujawsko-pomorskie,Powiat aleksandrowski,M.Ciechocinek,0401021,10921,10921,0
Wojewodztwo Kujawsko-pomorskie,Powiat aleksandrowski,M.Nieszawa,0401031,2009,2009,0
Wojewodztwo Kujawsko-pomorskie,Powiat aleksandrowski,G.Aleksandrów Kujawski,0401042,11438,0,11438
Wojewodztwo Kujawsko-pomorskie,Powiat aleksandrowski,G.Bądkowo,0401052,4502,0,4502
Wojewodztwo Kujawsko-pomorskie,Powiat aleksandrowski,G.Koneck,0401062,3354,0,3354
Wojewodztwo Kujawsko-pomorskie,Powiat aleksandrowski,G.Raciążek,0401072,3179,0,3179
Wojewodztwo Kujawsko-pomorskie,Powiat aleksandrowski,G.Waganiec,0401082,4568,0,4568
Wojewodztwo Kujawsko-pomorskie,Powiat aleksandrowski,G.Zakrzewo,0401092,3674,0,3674
Wojewodztwo Kujawsko-pomorskie,Powiat brodnicki,M.Brodnica,0402011,28416,28416,0
Wojewodztwo Kujawsko-pomorskie,Powiat brodnicki,G.Bobrowo,0402022,6260,0,6260
Wojewodztwo Kujawsko-pomorskie,Powiat brodnicki,G.Brodnica,0402032,7323,0,7323
Wojewodztwo Kujawsko-pomorskie,Powiat brodnicki,G.Brzozie,0402042,3738,0,3738
Wojewodztwo Kujawsko-pomorskie,Powiat brodnicki,M-W.Górzno,0402053,3953,1402,2551
Wojewodztwo Kujawsko-pomorskie,Powiat brodnicki,G.Bartniczka,0402062,4728,0,4728
Wojewodztwo Kujawsko-pomorskie,Powiat brodnicki,M-W.Jabłonowo Pomorskie,0402073,9110,3853,5257
Wojewodztwo Kujawsko-pomorskie,Powiat brodnicki,G.Osiek,0402082,4119,0,4119
Wojewodztwo Kujawsko-pomorskie,Powiat brodnicki,G.Świedziebnia,0402092,5195,0,5195
Wojewodztwo Kujawsko-pomorskie,Powiat brodnicki,G.Zbiczno,0402102,4687,0,4687
Wojewodztwo Kujawsko-pomorskie,Powiat bydgoski,G.Białe Błota,0403012,17579,0,17579
Wojewodztwo Kujawsko-pomorskie,Powiat bydgoski,G.Dąbrowa Chełmińska,0403022,7763,0,7763
Wojewodztwo Kujawsko-pomorskie,Powiat bydgoski,G.Dobrcz,0403032,10243,0,10243
Wojewodztwo Kujawsko-pomorskie,Powiat bydgoski,M-W.Koronowo,0403043,24022,11332,12690
Wojewodztwo Kujawsko-pomorskie,Powiat bydgoski,G.Nowa Wieś Wielka,0403052,9210,0,9210
Wojewodztwo Kujawsko-pomorskie,Powiat bydgoski,G.Osielsko,0403062,11308,0,11308
Wojewodztwo Kujawsko-pomorskie,Powiat bydgoski,G.Sicienko,0403072,9546,0,9546
Wojewodztwo Kujawsko-pomorskie,Powiat bydgoski,M-W.Solec Kujawski,0403083,16688,15596,1092
Wojewodztwo Kujawsko-pomorskie,Powiat chełmiński,M.Chełmno,0404011,20934,20934,0
Wojewodztwo Kujawsko-pomorskie,Powiat chełmiński,G.Chełmno,0404022,5496,0,5496
Wojewodztwo Kujawsko-pomorskie,Powiat chełmiński,G.Kijewo Królewskie,0404032,4401,0,4401
Wojewodztwo Kujawsko-pomorskie,Powiat chełmiński,G.Lisewo,0404042,5274,0,5274
Wojewodztwo Kujawsko-pomorskie,Powiat chełmiński,G.Papowo Biskupie,0404052,4456,0,4456
Wojewodztwo Kujawsko-pomorskie,Powiat chełmiński,G.Stolno,0404062,5167,0,5167
Wojewodztwo Kujawsko-pomorskie,Powiat chełmiński,G.Unisław,0404072,6979,0,6979
Wojewodztwo Kujawsko-pomorskie,Powiat golubsko-dobrzyński,M.Golub-Dobrzyń,0405011,12959,12959,0
Wojewodztwo Kujawsko-pomorskie,Powiat golubsko-dobrzyński,G.Ciechocin,0405022,4019,0,4019
Wojewodztwo Kujawsko-pomorskie,Powiat golubsko-dobrzyński,G.Golub-Dobrzyń,0405032,8342,0,8342
Wojewodztwo Kujawsko-pomorskie,Powiat golubsko-dobrzyński,M-W.Kowalewo Pomorskie,0405043,11573,4260,7313
Wojewodztwo Kujawsko-pomorskie,Powiat golubsko-dobrzyński,G.Radomin,0405052,4030,0,4030
Wojewodztwo Kujawsko-pomorskie,Powiat golubsko-dobrzyński,G.Zbójno,0405062,4424,0,4424
Wojewodztwo Kujawsko-pomorskie,Powiat grudziądzki,G.Grudziądz,0406012,11719,0,11719
Wojewodztwo Kujawsko-pomorskie,Powiat grudziądzki,G.Gruta,0406022,6535,0,6535
Wojewodztwo Kujawsko-pomorskie,Powiat grudziądzki,M-W.Łasin,0406033,8382,3415,4967
Wojewodztwo Kujawsko-pomorskie,Powiat grudziądzki,M-W.Radzyń Chełmiński,0406043,4938,1935,3003
Wojewodztwo Kujawsko-pomorskie,Powiat grudziądzki,G.Rogóźno,0406052,4186,0,4186
Wojewodztwo Kujawsko-pomorskie,Powiat grudziądzki,G.Świecie nad Osą,0406062,4397,0,4397
Wojewodztwo Kujawsko-pomorskie,Powiat inowrocławski,M.Inowrocław,0407011,76086,76086,0
Wojewodztwo Kujawsko-pomorskie,Powiat inowrocławski,G.Dąbrowa Biskupia,0407022,5140,0,5140
Wojewodztwo Kujawsko-pomorskie,Powiat inowrocławski,M-W.Gniewkowo,0407033,15015,7428,7587
Wojewodztwo Kujawsko-pomorskie,Powiat inowrocławski,G.Inowrocław,0407042,11307,0,11307
Wojewodztwo Kujawsko-pomorskie,Powiat inowrocławski,M-W.Janikowo,0407053,13652,9186,4466
Wojewodztwo Kujawsko-pomorskie,Powiat inowrocławski,M-W.Kruszwica,0407063,20077,9330,10747
Wojewodztwo Kujawsko-pomorskie,Powiat inowrocławski,M-W.Pakość,0407073,10008,5870,4138
Wojewodztwo Kujawsko-pomorskie,Powiat inowrocławski,G.Rojewo,0407082,4756,0,4756
Wojewodztwo Kujawsko-pomorskie,Powiat inowrocławski,G.Złotniki Kujawskie,0407092,9165,0,9165
Wojewodztwo Kujawsko-pomorskie,Powiat lipnowski,M.Lipno,0408011,15080,15080,0
Wojewodztwo Kujawsko-pomorskie,Powiat lipnowski,G.Bobrowniki,0408022,3117,0,3117
Wojewodztwo Kujawsko-pomorskie,Powiat lipnowski,G.Chrostkowo,0408032,3059,0,3059
Wojewodztwo Kujawsko-pomorskie,Powiat lipnowski,M-W.Dobrzyń nad Wisłą,0408043,8033,2334,5699
Wojewodztwo Kujawsko-pomorskie,Powiat lipnowski,G.Kikół,0408052,7327,0,7327
Wojewodztwo Kujawsko-pomorskie,Powiat lipnowski,G.Lipno,0408062,11646,0,11646
Wojewodztwo Kujawsko-pomorskie,Powiat lipnowski,M-W.Skępe,0408073,7833,3684,4149
Wojewodztwo Kujawsko-pomorskie,Powiat lipnowski,G.Tłuchowo,0408082,4722,0,4722
Wojewodztwo Kujawsko-pomorskie,Powiat lipnowski,G.Wielgie,0408092,6804,0,6804
Wojewodztwo Kujawsko-pomorskie,Powiat mogileński,G.Dąbrowa,0409012,4747,0,4747
Wojewodztwo Kujawsko-pomorskie,Powiat mogileński,G.Jeziora Wielkie,0409022,5082,0,5082
Wojewodztwo Kujawsko-pomorskie,Powiat mogileński,M-W.Mogilno,0409033,25105,12547,12558
Wojewodztwo Kujawsko-pomorskie,Powiat mogileński,M-W.Strzelno,0409043,12090,5885,6205
Wojewodztwo Kujawsko-pomorskie,Powiat nakielski,M-W.Kcynia,0410013,13704,4724,8980
Wojewodztwo Kujawsko-pomorskie,Powiat nakielski,M-W.Mrocza,0410023,9310,4393,4917
Wojewodztwo Kujawsko-pomorskie,Powiat nakielski,M-W.Nakło nad Notecią,0410033,32678,19542,13136
Wojewodztwo Kujawsko-pomorskie,Powiat nakielski,G.Sadki,0410042,7279,0,7279
Wojewodztwo Kujawsko-pomorskie,Powiat nakielski,M-W.Szubin,0410053,23895,9532,14363
Wojewodztwo Kujawsko-pomorskie,Powiat radziejowski,M.Radziejów,0411011,5944,5944,0
Wojewodztwo Kujawsko-pomorskie,Powiat radziejowski,G.Bytoń,0411022,3668,0,3668
Wojewodztwo Kujawsko-pomorskie,Powiat radziejowski,G.Dobre,0411032,5574,0,5574
Wojewodztwo Kujawsko-pomorskie,Powiat radziejowski,G.Osięciny,0411042,8088,0,8088
Wojewodztwo Kujawsko-pomorskie,Powiat radziejowski,M-W.Piotrków Kujawski,0411053,9649,4535,5114
Wojewodztwo Kujawsko-pomorskie,Powiat radziejowski,G.Radziejów,0411062,4476,0,4476
Wojewodztwo Kujawsko-pomorskie,Powiat radziejowski,G.Topólka,0411072,5024,0,5024
Wojewodztwo Kujawsko-pomorskie,Powiat rypiński,M.Rypin,0412011,16902,16902,0
Wojewodztwo Kujawsko-pomorskie,Powiat rypiński,G.Brzuze,0412022,5385,0,5385
Wojewodztwo Kujawsko-pomorskie,Powiat rypiński,G.Rogowo,0412032,4855,0,4855
Wojewodztwo Kujawsko-pomorskie,Powiat rypiński,G.Rypin,0412042,7377,0,7377
Wojewodztwo Kujawsko-pomorskie,Powiat rypiński,G.Skrwilno,0412052,6243,0,6243
Wojewodztwo Kujawsko-pomorskie,Powiat rypiński,G.Wąpielsk,0412062,4130,0,4130
Wojewodztwo Kujawsko-pomorskie,Powiat sępoleński,M-W.Kamień Krajeński,0413013,7032,2373,4659
Wojewodztwo Kujawsko-pomorskie,Powiat sępoleński,M-W.Sępólno Krajeńskie,0413023,16142,9336,6806
Wojewodztwo Kujawsko-pomorskie,Powiat sępoleński,G.Sośno,0413032,5157,0,5157
Wojewodztwo Kujawsko-pomorskie,Powiat sępoleński,M-W.Więcbork,0413043,13380,6012,7368
Wojewodztwo Kujawsko-pomorskie,Powiat świecki,G.Bukowiec,0414012,5192,0,5192
Wojewodztwo Kujawsko-pomorskie,Powiat świecki,G.Dragacz,0414022,7145,0,7145
Wojewodztwo Kujawsko-pomorskie,Powiat świecki,G.Drzycim,0414032,5045,0,5045
Wojewodztwo Kujawsko-pomorskie,Powiat świecki,G.Jeżewo,0414042,7939,0,7939
Wojewodztwo Kujawsko-pomorskie,Powiat świecki,G.Lniano,0414052,4219,0,4219
Wojewodztwo Kujawsko-pomorskie,Powiat świecki,M-W.Nowe,0414063,10841,6295,4546
Wojewodztwo Kujawsko-pomorskie,Powiat świecki,G.Osie,0414072,5413,0,5413
Wojewodztwo Kujawsko-pomorskie,Powiat świecki,G.Pruszcz,0414082,9579,0,9579
Wojewodztwo Kujawsko-pomorskie,Powiat świecki,M-W.Świecie,0414093,34313,26650,7663
Wojewodztwo Kujawsko-pomorskie,Powiat świecki,G.Świekatowo,0414102,3526,0,3526
Wojewodztwo Kujawsko-pomorskie,Powiat świecki,G.Warlubie,0414112,6643,0,6643
Wojewodztwo Kujawsko-pomorskie,Powiat toruński,M.Chełmża,0415011,15250,15250,0
Wojewodztwo Kujawsko-pomorskie,Powiat toruński,G.Chełmża,0415022,9638,0,9638
Wojewodztwo Kujawsko-pomorskie,Powiat toruński,G.Czernikowo,0415032,8880,0,8880
Wojewodztwo Kujawsko-pomorskie,Powiat toruński,G.Lubicz,0415042,18471,0,18471
Wojewodztwo Kujawsko-pomorskie,Powiat toruński,G.Łubianka,0415052,6316,0,6316
Wojewodztwo Kujawsko-pomorskie,Powiat toruński,G.Łysomice,0415062,9080,0,9080
Wojewodztwo Kujawsko-pomorskie,Powiat toruński,G.Obrowo,0415072,12769,0,12769
Wojewodztwo Kujawsko-pomorskie,Powiat toruński,G.Wielka Nieszawka,0415082,4644,0,4644
Wojewodztwo Kujawsko-pomorskie,Powiat toruński,G.Zławieś Wielka,0415092,12617,0,12617
Wojewodztwo Kujawsko-pomorskie,Powiat tucholski,G.Cekcyn,0416012,6573,0,6573
Wojewodztwo Kujawsko-pomorskie,Powiat tucholski,G.Gostycyn,0416022,5259,0,5259
Wojewodztwo Kujawsko-pomorskie,Powiat tucholski,G.Kęsowo,0416032,4486,0,4486
Wojewodztwo Kujawsko-pomorskie,Powiat tucholski,G.Lubiewo,0416042,5825,0,5825
Wojewodztwo Kujawsko-pomorskie,Powiat tucholski,G.Śliwice,0416052,5591,0,5591
Wojewodztwo Kujawsko-pomorskie,Powiat tucholski,M-W.Tuchola,0416063,20373,14022,6351
Wojewodztwo Kujawsko-pomorskie,Powiat wąbrzeski,M.Wąbrzeźno,0417011,14242,14242,0
Wojewodztwo Kujawsko-pomorskie,Powiat wąbrzeski,G.Dębowa Łąka,0417022,3243,0,3243
Wojewodztwo Kujawsko-pomorskie,Powiat wąbrzeski,G.Książki,0417032,4279,0,4279
Wojewodztwo Kujawsko-pomorskie,Powiat wąbrzeski,G.Płużnica,0417042,4945,0,4945
Wojewodztwo Kujawsko-pomorskie,Powiat wąbrzeski,G.Wąbrzeźno,0417052,8562,0,8562
Wojewodztwo Kujawsko-pomorskie,Powiat włocławski,M.Kowal,0418011,3535,3535,0
Wojewodztwo Kujawsko-pomorskie,Powiat włocławski,G.Baruchowo,0418022,3584,0,3584
Wojewodztwo Kujawsko-pomorskie,Powiat włocławski,G.Boniewo,0418032,3578,0,3578
Wojewodztwo Kujawsko-pomorskie,Powiat włocławski,M-W.Brześć Kujawski,0418043,11588,4746,6842
Wojewodztwo Kujawsko-pomorskie,Powiat włocławski,G.Choceń,0418052,8125,0,8125
Wojewodztwo Kujawsko-pomorskie,Powiat włocławski,M-W.Chodecz,0418063,6292,1920,4372
Wojewodztwo Kujawsko-pomorskie,Powiat włocławski,G.Fabianki,0418072,9424,0,9424
Wojewodztwo Kujawsko-pomorskie,Powiat włocławski,M-W.Izbica Kujawska,0418083,7968,2810,5158
Wojewodztwo Kujawsko-pomorskie,Powiat włocławski,G.Kowal,0418092,3995,0,3995
Wojewodztwo Kujawsko-pomorskie,Powiat włocławski,G.Lubanie,0418102,4678,0,4678
Wojewodztwo Kujawsko-pomorskie,Powiat włocławski,M-W.Lubień Kujawski,0418113,7597,1387,6210
Wojewodztwo Kujawsko-pomorskie,Powiat włocławski,M-W.Lubraniec,0418123,9956,3230,6726
Wojewodztwo Kujawsko-pomorskie,Powiat włocławski,G.Włocławek,0418132,6925,0,6925
Wojewodztwo Kujawsko-pomorskie,Powiat żniński,M-W.Barcin,0419013,15068,7911,7157
Wojewodztwo Kujawsko-pomorskie,Powiat żniński,G.Gąsawa,0419022,5273,0,5273
Wojewodztwo Kujawsko-pomorskie,Powiat żniński,M-W.Janowiec Wielkopolski,0419033,9342,4135,5207
Wojewodztwo Kujawsko-pomorskie,Powiat żniński,M-W.Łabiszyn,0419043,9714,4549,5165
Wojewodztwo Kujawsko-pomorskie,Powiat żniński,G.Rogowo,0419052,6945,0,6945
Wojewodztwo Kujawsko-pomorskie,Powiat żniński,M-W.Żnin,0419063,24659,14381,10278
Wojewodztwo Kujawsko-pomorskie,Powiat żniński,m. Bydgoszcz,0461,363926,363926,0
Wojewodztwo Kujawsko-pomorskie,Powiat żniński,m. Grudziądz,0462,98726,98726,0
Wojewodztwo Kujawsko-pomorskie,Powiat żniński,m. Toruń,0463,204954,204954,0
Wojewodztwo Kujawsko-pomorskie,Powiat żniński,m. Włocławek,0464,116783,116783,0
Wojewodztwo Lubelskie,Powiat bialski,M.Międzyrzec Podlaski,0601011,17321,17321,0
Wojewodztwo Lubelskie,Powiat bialski,M.Terespol,0601021,5901,5901,0
Wojewodztwo Lubelskie,Powiat bialski,G.Biała Podlaska,0601032,13427,0,13427
Wojewodztwo Lubelskie,Powiat bialski,G.Drelów,0601042,5551,0,5551
Wojewodztwo Lubelskie,Powiat bialski,G.Janów Podlaski,0601052,5571,0,5571
Wojewodztwo Lubelskie,Powiat bialski,G.Kodeń,0601062,3825,0,3825
Wojewodztwo Lubelskie,Powiat bialski,G.Konstantynów,0601072,4141,0,4141
Wojewodztwo Lubelskie,Powiat bialski,G.Leśna Podlaska,0601082,4341,0,4341
Wojewodztwo Lubelskie,Powiat bialski,G.Łomazy,0601092,5265,0,5265
Wojewodztwo Lubelskie,Powiat bialski,G.Międzyrzec Podlaski,0601102,10529,0,10529
Wojewodztwo Lubelskie,Powiat bialski,G.Piszczac,0601112,7530,0,7530
Wojewodztwo Lubelskie,Powiat bialski,G.Rokitno,0601122,3206,0,3206
Wojewodztwo Lubelskie,Powiat bialski,G.Rossosz,0601132,2391,0,2391
Wojewodztwo Lubelskie,Powiat bialski,G.Sławatycze,0601142,2551,0,2551
Wojewodztwo Lubelskie,Powiat bialski,G.Sosnówka,0601152,2664,0,2664
Wojewodztwo Lubelskie,Powiat bialski,G.Terespol,0601162,6969,0,6969
Wojewodztwo Lubelskie,Powiat bialski,G.Tuczna,0601172,3369,0,3369
Wojewodztwo Lubelskie,Powiat bialski,G.Wisznice,0601182,5235,0,5235
Wojewodztwo Lubelskie,Powiat bialski,G.Zalesie,0601192,4473,0,4473
Wojewodztwo Lubelskie,Powiat biłgorajski,M.Biłgoraj,0602011,27291,27291,0
Wojewodztwo Lubelskie,Powiat biłgorajski,G.Aleksandrów,0602022,3266,0,3266
Wojewodztwo Lubelskie,Powiat biłgorajski,G.Biłgoraj,0602032,12909,0,12909
Wojewodztwo Lubelskie,Powiat biłgorajski,G.Biszcza,0602042,3864,0,3864
Wojewodztwo Lubelskie,Powiat biłgorajski,M-W.Frampol,0602053,6403,1487,4916
Wojewodztwo Lubelskie,Powiat biłgorajski,G.Goraj,0602062,4339,0,4339
Wojewodztwo Lubelskie,Powiat biłgorajski,M-W.Józefów,0602073,7105,2530,4575
Wojewodztwo Lubelskie,Powiat biłgorajski,G.Księżpol,0602082,6872,0,6872
Wojewodztwo Lubelskie,Powiat biłgorajski,G.Łukowa,0602092,4349,0,4349
Wojewodztwo Lubelskie,Powiat biłgorajski,G.Obsza,0602102,4366,0,4366
Wojewodztwo Lubelskie,Powiat biłgorajski,G.Potok Górny,0602112,5567,0,5567
Wojewodztwo Lubelskie,Powiat biłgorajski,M-W.Tarnogród,0602123,6942,3495,3447
Wojewodztwo Lubelskie,Powiat biłgorajski,G.Tereszpol,0602132,3994,0,3994
Wojewodztwo Lubelskie,Powiat biłgorajski,G.Turobin,0602142,6660,0,6660
Wojewodztwo Lubelskie,Powiat chełmski,M.Rejowiec Fabryczny,0603011,4579,4579,0
Wojewodztwo Lubelskie,Powiat chełmski,G.Białopole,0603022,3211,0,3211
Wojewodztwo Lubelskie,Powiat chełmski,G.Chełm,0603032,13716,0,13716
Wojewodztwo Lubelskie,Powiat chełmski,G.Dorohusk,0603042,6856,0,6856
Wojewodztwo Lubelskie,Powiat chełmski,G.Dubienka,0603052,2511,0,2511
Wojewodztwo Lubelskie,Powiat chełmski,G.Kamień,0603062,4083,0,4083
Wojewodztwo Lubelskie,Powiat chełmski,G.Leśniowice,0603072,3897,0,3897
Wojewodztwo Lubelskie,Powiat chełmski,G.Rejowiec Fabryczny,0603082,4479,0,4479
Wojewodztwo Lubelskie,Powiat chełmski,G.Ruda-Huta,0603092,4794,0,4794
Wojewodztwo Lubelskie,Powiat chełmski,G.Sawin,0603102,5705,0,5705
Wojewodztwo Lubelskie,Powiat chełmski,G.Siedliszcze,0603112,7078,0,7078
Wojewodztwo Lubelskie,Powiat chełmski,G.Wierzbica,0603122,5462,0,5462
Wojewodztwo Lubelskie,Powiat chełmski,G.Wojsławice,0603132,4061,0,4061
Wojewodztwo Lubelskie,Powiat chełmski,G.Żmudź,0603142,3303,0,3303
Wojewodztwo Lubelskie,Powiat chełmski,G.Rejowiec,0603152,6691,0,6691
Wojewodztwo Lubelskie,Powiat hrubieszowski,M.Hrubieszów,0604011,18850,18850,0
Wojewodztwo Lubelskie,Powiat hrubieszowski,G.Dołhobyczów,0604022,6034,0,6034
Wojewodztwo Lubelskie,Powiat hrubieszowski,G.Horodło,0604032,5633,0,5633
Wojewodztwo Lubelskie,Powiat hrubieszowski,G.Hrubieszów,0604042,10637,0,10637
Wojewodztwo Lubelskie,Powiat hrubieszowski,G.Mircze,0604052,7744,0,7744
Wojewodztwo Lubelskie,Powiat hrubieszowski,G.Trzeszczany,0604062,4661,0,4661
Wojewodztwo Lubelskie,Powiat hrubieszowski,G.Uchanie,0604072,4973,0,4973
Wojewodztwo Lubelskie,Powiat hrubieszowski,G.Werbkowice,0604082,10088,0,10088
Wojewodztwo Lubelskie,Powiat janowski,G.Batorz,0605012,3485,0,3485
Wojewodztwo Lubelskie,Powiat janowski,G.Chrzanów,0605022,3073,0,3073
Wojewodztwo Lubelskie,Powiat janowski,G.Dzwola,0605032,6586,0,6586
Wojewodztwo Lubelskie,Powiat janowski,G.Godziszów,0605042,6172,0,6172
Wojewodztwo Lubelskie,Powiat janowski,M-W.Janów Lubelski,0605053,16374,12186,4188
Wojewodztwo Lubelskie,Powiat janowski,G.Modliborzyce,0605062,7271,0,7271
Wojewodztwo Lubelskie,Powiat janowski,G.Potok Wielki,0605072,4924,0,4924
Wojewodztwo Lubelskie,Powiat krasnostawski,M.Krasnystaw,0606011,19692,19692,0
Wojewodztwo Lubelskie,Powiat krasnostawski,G.Fajsławice,0606022,4850,0,4850
Wojewodztwo Lubelskie,Powiat krasnostawski,G.Gorzków,0606032,3790,0,3790
Wojewodztwo Lubelskie,Powiat krasnostawski,G.Izbica,0606042,8662,0,8662
Wojewodztwo Lubelskie,Powiat krasnostawski,G.Krasnystaw,0606052,8972,0,8972
Wojewodztwo Lubelskie,Powiat krasnostawski,G.Kraśniczyn,0606062,4083,0,4083
Wojewodztwo Lubelskie,Powiat krasnostawski,G.Łopiennik Górny,0606072,4178,0,4178
Wojewodztwo Lubelskie,Powiat krasnostawski,G.Rudnik,0606092,3349,0,3349
Wojewodztwo Lubelskie,Powiat krasnostawski,G.Siennica Różana,0606102,4263,0,4263
Wojewodztwo Lubelskie,Powiat krasnostawski,G.Żółkiewka,0606112,5826,0,5826
Wojewodztwo Lubelskie,Powiat kraśnicki,M.Kraśnik,0607011,36370,36370,0
Wojewodztwo Lubelskie,Powiat kraśnicki,M-W.Annopol,0607023,9175,2682,6493
Wojewodztwo Lubelskie,Powiat kraśnicki,G.Dzierzkowice,0607032,5410,0,5410
Wojewodztwo Lubelskie,Powiat kraśnicki,G.Gościeradów,0607042,7397,0,7397
Wojewodztwo Lubelskie,Powiat kraśnicki,G.Kraśnik,0607052,7368,0,7368
Wojewodztwo Lubelskie,Powiat kraśnicki,G.Szastarka,0607062,6020,0,6020
Wojewodztwo Lubelskie,Powiat kraśnicki,G.Trzydnik Duży,0607072,6847,0,6847
Wojewodztwo Lubelskie,Powiat kraśnicki,G.Urzędów,0607082,8884,0,8884
Wojewodztwo Lubelskie,Powiat kraśnicki,G.Wilkołaz,0607092,5501,0,5501
Wojewodztwo Lubelskie,Powiat kraśnicki,G.Zakrzówek,0607102,6851,0,6851
Wojewodztwo Lubelskie,Powiat lubartowski,M.Lubartów,0608011,22773,22773,0
Wojewodztwo Lubelskie,Powiat lubartowski,G.Abramów,0608022,4252,0,4252
Wojewodztwo Lubelskie,Powiat lubartowski,G.Firlej,0608032,6057,0,6057
Wojewodztwo Lubelskie,Powiat lubartowski,G.Jeziorzany,0608042,2992,0,2992
Wojewodztwo Lubelskie,Powiat lubartowski,G.Kamionka,0608052,6439,0,6439
Wojewodztwo Lubelskie,Powiat lubartowski,M-W.Kock,0608063,6807,3479,3328
Wojewodztwo Lubelskie,Powiat lubartowski,G.Lubartów,0608072,10845,0,10845
Wojewodztwo Lubelskie,Powiat lubartowski,G.Michów,0608082,6187,0,6187
Wojewodztwo Lubelskie,Powiat lubartowski,G.Niedźwiada,0608092,6326,0,6326
Wojewodztwo Lubelskie,Powiat lubartowski,M-W.Ostrów Lubelski,0608103,5473,2193,3280
Wojewodztwo Lubelskie,Powiat lubartowski,G.Ostrówek,0608112,4059,0,4059
Wojewodztwo Lubelskie,Powiat lubartowski,G.Serniki,0608122,4876,0,4876
Wojewodztwo Lubelskie,Powiat lubartowski,G.Uścimów,0608132,3373,0,3373
Wojewodztwo Lubelskie,Powiat lubelski,M-W.Bełżyce,0609013,13598,6875,6723
Wojewodztwo Lubelskie,Powiat lubelski,G.Borzechów,0609022,3808,0,3808
Wojewodztwo Lubelskie,Powiat lubelski,M-W.Bychawa,0609033,12311,5343,6968
Wojewodztwo Lubelskie,Powiat lubelski,G.Garbów,0609042,8965,0,8965
Wojewodztwo Lubelskie,Powiat lubelski,G.Głusk,0609052,8903,0,8903
Wojewodztwo Lubelskie,Powiat lubelski,G.Jabłonna,0609062,7878,0,7878
Wojewodztwo Lubelskie,Powiat lubelski,G.Jastków,0609072,13176,0,13176
Wojewodztwo Lubelskie,Powiat lubelski,G.Konopnica,0609082,12227,0,12227
Wojewodztwo Lubelskie,Powiat lubelski,G.Krzczonów,0609092,4730,0,4730
Wojewodztwo Lubelskie,Powiat lubelski,G.Niedrzwica Duża,0609102,11435,0,11435
Wojewodztwo Lubelskie,Powiat lubelski,G.Niemce,0609112,17727,0,17727
Wojewodztwo Lubelskie,Powiat lubelski,G.Strzyżewice,0609122,7681,0,7681
Wojewodztwo Lubelskie,Powiat lubelski,G.Wojciechów,0609132,5945,0,5945
Wojewodztwo Lubelskie,Powiat lubelski,G.Wólka,0609142,10379,0,10379
Wojewodztwo Lubelskie,Powiat lubelski,G.Wysokie,0609152,4831,0,4831
Wojewodztwo Lubelskie,Powiat lubelski,G.Zakrzew,0609162,3072,0,3072
Wojewodztwo Lubelskie,Powiat łęczyński,G.Cyców,0610012,7795,0,7795
Wojewodztwo Lubelskie,Powiat łęczyński,G.Ludwin,0610022,5205,0,5205
Wojewodztwo Lubelskie,Powiat łęczyński,M-W.Łęczna,0610033,24592,20703,3889
Wojewodztwo Lubelskie,Powiat łęczyński,G.Milejów,0610042,9365,0,9365
Wojewodztwo Lubelskie,Powiat łęczyński,G.Puchaczów,0610052,5214,0,5214
Wojewodztwo Lubelskie,Powiat łęczyński,G.Spiczyn,0610062,5500,0,5500
Wojewodztwo Lubelskie,Powiat łukowski,M.Łuków,0611011,31040,31040,0
Wojewodztwo Lubelskie,Powiat łukowski,M.Stoczek Łukowski,0611021,2739,2739,0
Wojewodztwo Lubelskie,Powiat łukowski,G.Adamów,0611032,5901,0,5901
Wojewodztwo Lubelskie,Powiat łukowski,G.Krzywda,0611042,10688,0,10688
Wojewodztwo Lubelskie,Powiat łukowski,G.Łuków,0611052,17377,0,17377
Wojewodztwo Lubelskie,Powiat łukowski,G.Serokomla,0611062,4267,0,4267
Wojewodztwo Lubelskie,Powiat łukowski,G.Stanin,0611072,9882,0,9882
Wojewodztwo Lubelskie,Powiat łukowski,G.Stoczek Łukowski,0611082,8345,0,8345
Wojewodztwo Lubelskie,Powiat łukowski,G.Trzebieszów,0611092,7646,0,7646
Wojewodztwo Lubelskie,Powiat łukowski,G.Wojcieszków,0611102,7105,0,7105
Wojewodztwo Lubelskie,Powiat łukowski,G.Wola Mysłowska,0611112,5067,0,5067
Wojewodztwo Lubelskie,Powiat opolski,G.Chodel,0612012,6844,0,6844
Wojewodztwo Lubelskie,Powiat opolski,G.Józefów nad Wisłą,0612022,6978,0,6978
Wojewodztwo Lubelskie,Powiat opolski,G.Karczmiska,0612032,5834,0,5834
Wojewodztwo Lubelskie,Powiat opolski,G.Łaziska,0612042,5231,0,5231
Wojewodztwo Lubelskie,Powiat opolski,M-W.Opole Lubelskie,0612053,18049,9012,9037
Wojewodztwo Lubelskie,Powiat opolski,M-W.Poniatowa,0612063,15147,9909,5238
Wojewodztwo Lubelskie,Powiat opolski,G.Wilków,0612072,4816,0,4816
Wojewodztwo Lubelskie,Powiat parczewski,G.Dębowa Kłoda,0613012,3999,0,3999
Wojewodztwo Lubelskie,Powiat parczewski,G.Jabłoń,0613022,4065,0,4065
Wojewodztwo Lubelskie,Powiat parczewski,G.Milanów,0613032,4077,0,4077
Wojewodztwo Lubelskie,Powiat parczewski,M-W.Parczew,0613043,14921,10980,3941
Wojewodztwo Lubelskie,Powiat parczewski,G.Podedwórze,0613052,1769,0,1769
Wojewodztwo Lubelskie,Powiat parczewski,G.Siemień,0613062,4844,0,4844
Wojewodztwo Lubelskie,Powiat parczewski,G.Sosnowica,0613072,2755,0,2755
Wojewodztwo Lubelskie,Powiat puławski,M.Puławy,0614011,49941,49941,0
Wojewodztwo Lubelskie,Powiat puławski,G.Baranów,0614022,4128,0,4128
Wojewodztwo Lubelskie,Powiat puławski,G.Janowiec,0614032,3678,0,3678
Wojewodztwo Lubelskie,Powiat puławski,M-W.Kazimierz Dolny,0614043,7021,2696,4325
Wojewodztwo Lubelskie,Powiat puławski,G.Końskowola,0614052,9073,0,9073
Wojewodztwo Lubelskie,Powiat puławski,G.Kurów,0614062,7809,0,7809
Wojewodztwo Lubelskie,Powiat puławski,G.Markuszów,0614072,3050,0,3050
Wojewodztwo Lubelskie,Powiat puławski,M-W.Nałęczów,0614083,9332,4104,5228
Wojewodztwo Lubelskie,Powiat puławski,G.Puławy,0614092,11641,0,11641
Wojewodztwo Lubelskie,Powiat puławski,G.Wąwolnica,0614102,4869,0,4869
Wojewodztwo Lubelskie,Powiat puławski,G.Żyrzyn,0614112,6593,0,6593
Wojewodztwo Lubelskie,Powiat radzyński,M.Radzyń Podlaski,0615011,16233,16233,0
Wojewodztwo Lubelskie,Powiat radzyński,G.Borki,0615022,6141,0,6141
Wojewodztwo Lubelskie,Powiat radzyński,G.Czemierniki,0615032,4588,0,4588
Wojewodztwo Lubelskie,Powiat radzyński,G.Kąkolewnica,0615042,8523,0,8523
Wojewodztwo Lubelskie,Powiat radzyński,G.Komarówka Podlaska,0615052,4576,0,4576
Wojewodztwo Lubelskie,Powiat radzyński,G.Radzyń Podlaski,0615062,8057,0,8057
Wojewodztwo Lubelskie,Powiat radzyński,G.Ulan-Majorat,0615072,6184,0,6184
Wojewodztwo Lubelskie,Powiat radzyński,G.Wohyń,0615082,7144,0,7144
Wojewodztwo Lubelskie,Powiat rycki,M.Dęblin,0616011,17707,17707,0
Wojewodztwo Lubelskie,Powiat rycki,G.Kłoczew,0616022,7490,0,7490
Wojewodztwo Lubelskie,Powiat rycki,G.Nowodwór,0616032,4277,0,4277
Wojewodztwo Lubelskie,Powiat rycki,M-W.Ryki,0616043,20866,10010,10856
Wojewodztwo Lubelskie,Powiat rycki,G.Stężyca,0616052,5414,0,5414
Wojewodztwo Lubelskie,Powiat rycki,G.Ułęż,0616062,3383,0,3383
Wojewodztwo Lubelskie,Powiat świdnicki,M.Świdnik,0617011,40710,40710,0
Wojewodztwo Lubelskie,Powiat świdnicki,G.Mełgiew,0617022,8945,0,8945
Wojewodztwo Lubelskie,Powiat świdnicki,M-W.Piaski,0617033,10768,2718,8050
Wojewodztwo Lubelskie,Powiat świdnicki,G.Rybczewice,0617042,3705,0,3705
Wojewodztwo Lubelskie,Powiat świdnicki,G.Trawniki,0617052,9263,0,9263
Wojewodztwo Lubelskie,Powiat tomaszowski,M.Tomaszów Lubelski,0618011,20518,20518,0
Wojewodztwo Lubelskie,Powiat tomaszowski,G.Bełżec,0618022,3480,0,3480
Wojewodztwo Lubelskie,Powiat tomaszowski,G.Jarczów,0618032,3636,0,3636
Wojewodztwo Lubelskie,Powiat tomaszowski,G.Krynice,0618042,3518,0,3518
Wojewodztwo Lubelskie,Powiat tomaszowski,G.Lubycza Królewska,0618052,6646,0,6646
Wojewodztwo Lubelskie,Powiat tomaszowski,M-W.Łaszczów,0618063,6518,2213,4305
Wojewodztwo Lubelskie,Powiat tomaszowski,G.Rachanie,0618072,5514,0,5514
Wojewodztwo Lubelskie,Powiat tomaszowski,G.Susiec,0618082,7816,0,7816
Wojewodztwo Lubelskie,Powiat tomaszowski,G.Tarnawatka,0618092,4064,0,4064
Wojewodztwo Lubelskie,Powiat tomaszowski,G.Telatyn,0618102,4415,0,4415
Wojewodztwo Lubelskie,Powiat tomaszowski,G.Tomaszów Lubelski,0618112,11105,0,11105
Wojewodztwo Lubelskie,Powiat tomaszowski,M-W.Tyszowce,0618123,6087,2228,3859
Wojewodztwo Lubelskie,Powiat tomaszowski,G.Ulhówek,0618132,5100,0,5100
Wojewodztwo Lubelskie,Powiat włodawski,M.Włodawa,0619011,13798,13798,0
Wojewodztwo Lubelskie,Powiat włodawski,G.Hanna,0619022,3149,0,3149
Wojewodztwo Lubelskie,Powiat włodawski,G.Hańsk,0619032,3881,0,3881
Wojewodztwo Lubelskie,Powiat włodawski,G.Stary Brus,0619042,2180,0,2180
Wojewodztwo Lubelskie,Powiat włodawski,G.Urszulin,0619052,4139,0,4139
Wojewodztwo Lubelskie,Powiat włodawski,G.Włodawa,0619062,6049,0,6049
Wojewodztwo Lubelskie,Powiat włodawski,G.Wola Uhruska,0619072,4114,0,4114
Wojewodztwo Lubelskie,Powiat włodawski,G.Wyryki,0619082,2778,0,2778
Wojewodztwo Lubelskie,Powiat zamojski,G.Adamów,0620012,4935,0,4935
Wojewodztwo Lubelskie,Powiat zamojski,G.Grabowiec,0620022,4435,0,4435
Wojewodztwo Lubelskie,Powiat zamojski,G.Komarów-Osada,0620032,5380,0,5380
Wojewodztwo Lubelskie,Powiat zamojski,M-W.Krasnobród,0620043,7268,3110,4158
Wojewodztwo Lubelskie,Powiat zamojski,G.Łabunie,0620052,6370,0,6370
Wojewodztwo Lubelskie,Powiat zamojski,G.Miączyn,0620062,6214,0,6214
Wojewodztwo Lubelskie,Powiat zamojski,G.Nielisz,0620072,5833,0,5833
Wojewodztwo Lubelskie,Powiat zamojski,G.Radecznica,0620082,6096,0,6096
Wojewodztwo Lubelskie,Powiat zamojski,G.Sitno,0620092,6854,0,6854
Wojewodztwo Lubelskie,Powiat zamojski,G.Skierbieszów,0620102,5525,0,5525
Wojewodztwo Lubelskie,Powiat zamojski,G.Stary Zamość,0620112,5444,0,5444
Wojewodztwo Lubelskie,Powiat zamojski,G.Sułów,0620122,4877,0,4877
Wojewodztwo Lubelskie,Powiat zamojski,M-W.Szczebrzeszyn,0620133,11854,5294,6560
Wojewodztwo Lubelskie,Powiat zamojski,G.Zamość,0620142,21675,0,21675
Wojewodztwo Lubelskie,Powiat zamojski,M-W.Zwierzyniec,0620153,7098,3378,3720
Wojewodztwo Lubelskie,Powiat zamojski,m. Biała Podlaska,0661,58009,58009,0
Wojewodztwo Lubelskie,Powiat zamojski,m. Chełm,0662,66362,66362,0
Wojewodztwo Lubelskie,Powiat zamojski,m. Lublin,0663,349103,349103,0
Wojewodztwo Lubelskie,Powiat zamojski,m. Zamość,0664,65966,65966,0
Wojewodztwo Lubuskie,Powiat gorzowski,M.Kostrzyn nad Odrą,0801011,18070,18070,0
Wojewodztwo Lubuskie,Powiat gorzowski,G.Bogdaniec,0801022,7030,0,7030
Wojewodztwo Lubuskie,Powiat gorzowski,G.Deszczno,0801032,8448,0,8448
Wojewodztwo Lubuskie,Powiat gorzowski,G.Kłodawa,0801042,7506,0,7506
Wojewodztwo Lubuskie,Powiat gorzowski,G.Lubiszyn,0801052,6900,0,6900
Wojewodztwo Lubuskie,Powiat gorzowski,G.Santok,0801062,7871,0,7871
Wojewodztwo Lubuskie,Powiat gorzowski,M-W.Witnica,0801073,13092,6966,6126
Wojewodztwo Lubuskie,Powiat krośnieński,M.Gubin,0802011,17072,17072,0
Wojewodztwo Lubuskie,Powiat krośnieński,G.Bobrowice,0802022,3241,0,3241
Wojewodztwo Lubuskie,Powiat krośnieński,G.Bytnica,0802032,2618,0,2618
Wojewodztwo Lubuskie,Powiat krośnieński,G.Dąbie,0802042,5069,0,5069
Wojewodztwo Lubuskie,Powiat krośnieński,G.Gubin,0802052,7438,0,7438
Wojewodztwo Lubuskie,Powiat krośnieński,M-W.Krosno Odrzańskie,0802063,18667,12108,6559
Wojewodztwo Lubuskie,Powiat krośnieński,G.Maszewo,0802072,2957,0,2957
Wojewodztwo Lubuskie,Powiat międzyrzecki,G.Bledzew,0803012,4609,0,4609
Wojewodztwo Lubuskie,Powiat międzyrzecki,M-W.Międzyrzecz,0803023,25231,18753,6478
Wojewodztwo Lubuskie,Powiat międzyrzecki,G.Przytoczna,0803032,5645,0,5645
Wojewodztwo Lubuskie,Powiat międzyrzecki,G.Pszczew,0803042,4266,0,4266
Wojewodztwo Lubuskie,Powiat międzyrzecki,M-W.Skwierzyna,0803053,12687,10004,2683
Wojewodztwo Lubuskie,Powiat międzyrzecki,M-W.Trzciel,0803063,6500,2449,4051
Wojewodztwo Lubuskie,Powiat nowosolski,M.Nowa Sól,0804011,40369,40369,0
Wojewodztwo Lubuskie,Powiat nowosolski,M-W.Bytom Odrzański,0804023,5497,4430,1067
Wojewodztwo Lubuskie,Powiat nowosolski,G.Kolsko,0804032,3285,0,3285
Wojewodztwo Lubuskie,Powiat nowosolski,M-W.Kożuchów,0804043,16404,9784,6620
Wojewodztwo Lubuskie,Powiat nowosolski,G.Nowa Sól,0804052,6705,0,6705
Wojewodztwo Lubuskie,Powiat nowosolski,M-W.Nowe Miasteczko,0804063,5564,2885,2679
Wojewodztwo Lubuskie,Powiat nowosolski,G.Otyń,0804072,6630,0,6630
Wojewodztwo Lubuskie,Powiat nowosolski,G.Siedlisko,0804082,3629,0,3629
Wojewodztwo Lubuskie,Powiat słubicki,M-W.Cybinka,0805013,6775,2826,3949
Wojewodztwo Lubuskie,Powiat słubicki,G.Górzyca,0805022,4275,0,4275
Wojewodztwo Lubuskie,Powiat słubicki,M-W.Ośno Lubuskie,0805033,6545,3897,2648
Wojewodztwo Lubuskie,Powiat słubicki,M-W.Rzepin,0805043,10000,6732,3268
Wojewodztwo Lubuskie,Powiat słubicki,M-W.Słubice,0805053,19940,17045,2895
Wojewodztwo Lubuskie,Powiat strzelecko-drezdenecki,M-W.Dobiegniew,0806013,6908,3210,3698
Wojewodztwo Lubuskie,Powiat strzelecko-drezdenecki,M-W.Drezdenko,0806023,17618,10563,7055
Wojewodztwo Lubuskie,Powiat strzelecko-drezdenecki,G.Stare Kurowo,0806032,4221,0,4221
Wojewodztwo Lubuskie,Powiat strzelecko-drezdenecki,M-W.Strzelce Krajeńskie,0806043,17513,10218,7295
Wojewodztwo Lubuskie,Powiat strzelecko-drezdenecki,G.Zwierzyn,0806052,4449,0,4449
Wojewodztwo Lubuskie,Powiat sulęciński,G.Krzeszyce,0807012,4684,0,4684
Wojewodztwo Lubuskie,Powiat sulęciński,M-W.Lubniewice,0807023,3113,2001,1112
Wojewodztwo Lubuskie,Powiat sulęciński,G.Słońsk,0807032,4846,0,4846
Wojewodztwo Lubuskie,Powiat sulęciński,M-W.Sulęcin,0807043,16381,10248,6133
Wojewodztwo Lubuskie,Powiat sulęciński,M-W.Torzym,0807053,6951,2535,4416
Wojewodztwo Lubuskie,Powiat świebodziński,G.Lubrza,0808012,3514,0,3514
Wojewodztwo Lubuskie,Powiat świebodziński,G.Łagów,0808022,5256,0,5256
Wojewodztwo Lubuskie,Powiat świebodziński,G.Skąpe,0808032,5199,0,5199
Wojewodztwo Lubuskie,Powiat świebodziński,G.Szczaniec,0808042,3931,0,3931
Wojewodztwo Lubuskie,Powiat świebodziński,M-W.Świebodzin,0808053,30512,22166,8346
Wojewodztwo Lubuskie,Powiat świebodziński,M-W.Zbąszynek,0808063,8365,5052,3313
Wojewodztwo Lubuskie,Powiat zielonogórski,M-W.Babimost,0809013,6323,4049,2274
Wojewodztwo Lubuskie,Powiat zielonogórski,G.Bojadła,0809022,3366,0,3366
Wojewodztwo Lubuskie,Powiat zielonogórski,M-W.Czerwieńsk,0809033,9850,4201,5649
Wojewodztwo Lubuskie,Powiat zielonogórski,M-W.Kargowa,0809043,5839,3711,2128
Wojewodztwo Lubuskie,Powiat zielonogórski,M-W.Nowogród Bobrzański,0809053,9456,5172,4284
Wojewodztwo Lubuskie,Powiat zielonogórski,M-W.Sulechów,0809063,26726,17752,8974
Wojewodztwo Lubuskie,Powiat zielonogórski,G.Świdnica,0809072,6155,0,6155
Wojewodztwo Lubuskie,Powiat zielonogórski,G.Trzebiechów,0809082,3337,0,3337
Wojewodztwo Lubuskie,Powiat zielonogórski,G.Zabór,0809092,3826,0,3826
Wojewodztwo Lubuskie,Powiat zielonogórski,G.Zielona Góra,0809102,18497,0,18497
Wojewodztwo Lubuskie,Powiat żagański,M.Gozdnica,0810011,3356,3356,0
Wojewodztwo Lubuskie,Powiat żagański,M.Żagań,0810021,26791,26791,0
Wojewodztwo Lubuskie,Powiat żagański,G.Brzeźnica,0810032,3855,0,3855
Wojewodztwo Lubuskie,Powiat żagański,M-W.Iłowa,0810043,7137,4067,3070
Wojewodztwo Lubuskie,Powiat żagański,M-W.Małomice,0810053,5381,3634,1747
Wojewodztwo Lubuskie,Powiat żagański,G.Niegosławice,0810062,4660,0,4660
Wojewodztwo Lubuskie,Powiat żagański,M-W.Szprotawa,0810073,21958,12630,9328
Wojewodztwo Lubuskie,Powiat żagański,G.Wymiarki,0810082,2475,0,2475
Wojewodztwo Lubuskie,Powiat żagański,G.Żagań,0810092,7098,0,7098
Wojewodztwo Lubuskie,Powiat żarski,M.Łęknica,0811011,2631,2631,0
Wojewodztwo Lubuskie,Powiat żarski,M.Żary,0811021,39365,39365,0
Wojewodztwo Lubuskie,Powiat żarski,G.Brody,0811032,3571,0,3571
Wojewodztwo Lubuskie,Powiat żarski,M-W.Jasień,0811043,7314,4515,2799
Wojewodztwo Lubuskie,Powiat żarski,G.Lipinki Łużyckie,0811052,3269,0,3269
Wojewodztwo Lubuskie,Powiat żarski,M-W.Lubsko,0811063,19369,14774,4595
Wojewodztwo Lubuskie,Powiat żarski,G.Przewóz,0811072,3258,0,3258
Wojewodztwo Lubuskie,Powiat żarski,G.Trzebiel,0811082,5871,0,5871
Wojewodztwo Lubuskie,Powiat żarski,G.Tuplice,0811092,3264,0,3264
Wojewodztwo Lubuskie,Powiat żarski,G.Żary,0811102,11984,0,11984
Wojewodztwo Lubuskie,Powiat wschowski,M-W.Sława,0812013,12467,3966,8501
Wojewodztwo Lubuskie,Powiat wschowski,M-W.Szlichtyngowa,0812023,5131,1317,3814
Wojewodztwo Lubuskie,Powiat wschowski,M-W.Wschowa,0812033,21751,14467,7284
Wojewodztwo Lubuskie,Powiat wschowski,m. Gorzów Wielkopolski,0861,124534,124534,0
Wojewodztwo Lubuskie,Powiat wschowski,m. Zielona Góra,0862,118982,118982,0
Wojewodztwo Łódzkie,Powiat bełchatowski,M.Bełchatów,1001011,60485,60485,0
Wojewodztwo Łódzkie,Powiat bełchatowski,G.Bełchatów,1001022,10158,0,10158
Wojewodztwo Łódzkie,Powiat bełchatowski,G.Drużbice,1001032,5040,0,5040
Wojewodztwo Łódzkie,Powiat bełchatowski,G.Kleszczów,1001042,4735,0,4735
Wojewodztwo Łódzkie,Powiat bełchatowski,G.Kluki,1001052,4175,0,4175
Wojewodztwo Łódzkie,Powiat bełchatowski,G.Rusiec,1001062,5210,0,5210
Wojewodztwo Łódzkie,Powiat bełchatowski,G.Szczerców,1001072,8000,0,8000
Wojewodztwo Łódzkie,Powiat bełchatowski,M-W.Zelów,1001083,15180,7923,7257
Wojewodztwo Łódzkie,Powiat kutnowski,M.Kutno,1002011,46429,46429,0
Wojewodztwo Łódzkie,Powiat kutnowski,G.Bedlno,1002022,5917,0,5917
Wojewodztwo Łódzkie,Powiat kutnowski,G.Dąbrowice,1002032,2032,0,2032
Wojewodztwo Łódzkie,Powiat kutnowski,M-W.Krośniewice,1002043,8917,4617,4300
Wojewodztwo Łódzkie,Powiat kutnowski,G.Krzyżanów,1002052,4433,0,4433
Wojewodztwo Łódzkie,Powiat kutnowski,G.Kutno,1002062,8625,0,8625
Wojewodztwo Łódzkie,Powiat kutnowski,G.Łanięta,1002072,2584,0,2584
Wojewodztwo Łódzkie,Powiat kutnowski,G.Nowe Ostrowy,1002082,3735,0,3735
Wojewodztwo Łódzkie,Powiat kutnowski,G.Oporów,1002092,2696,0,2696
Wojewodztwo Łódzkie,Powiat kutnowski,G.Strzelce,1002102,4115,0,4115
Wojewodztwo Łódzkie,Powiat kutnowski,M-W.Żychlin,1002113,12751,8746,4005
Wojewodztwo Łódzkie,Powiat łaski,G.Buczek,1003012,4954,0,4954
Wojewodztwo Łódzkie,Powiat łaski,M-W.Łask,1003023,28577,18468,10109
Wojewodztwo Łódzkie,Powiat łaski,G.Sędziejowice,1003032,6403,0,6403
Wojewodztwo Łódzkie,Powiat łaski,G.Widawa,1003042,7700,0,7700
Wojewodztwo Łódzkie,Powiat łaski,G.Wodzierady,1003052,3225,0,3225
Wojewodztwo Łódzkie,Powiat łęczycki,M.Łęczyca,1004011,15035,15035,0
Wojewodztwo Łódzkie,Powiat łęczycki,G.Daszyna,1004022,4097,0,4097
Wojewodztwo Łódzkie,Powiat łęczycki,G.Góra Świętej Małgorzaty,1004032,4496,0,4496
Wojewodztwo Łódzkie,Powiat łęczycki,G.Grabów,1004042,6357,0,6357
Wojewodztwo Łódzkie,Powiat łęczycki,G.Łęczyca,1004052,8576,0,8576
Wojewodztwo Łódzkie,Powiat łęczycki,G.Piątek,1004062,6307,0,6307
Wojewodztwo Łódzkie,Powiat łęczycki,G.Świnice Warckie,1004072,4105,0,4105
Wojewodztwo Łódzkie,Powiat łęczycki,G.Witonia,1004082,3474,0,3474
Wojewodztwo Łódzkie,Powiat łowicki,M.Łowicz,1005011,29880,29880,0
Wojewodztwo Łódzkie,Powiat łowicki,G.Bielawy,1005022,5770,0,5770
Wojewodztwo Łódzkie,Powiat łowicki,G.Chąśno,1005032,3075,0,3075
Wojewodztwo Łódzkie,Powiat łowicki,G.Domaniewice,1005042,4643,0,4643
Wojewodztwo Łódzkie,Powiat łowicki,G.Kiernozia,1005052,3588,0,3588
Wojewodztwo Łódzkie,Powiat łowicki,G.Kocierzew Południowy,1005062,4436,0,4436
Wojewodztwo Łódzkie,Powiat łowicki,G.Łowicz,1005072,7515,0,7515
Wojewodztwo Łódzkie,Powiat łowicki,G.Łyszkowice,1005082,6791,0,6791
Wojewodztwo Łódzkie,Powiat łowicki,G.Nieborów,1005092,9422,0,9422
Wojewodztwo Łódzkie,Powiat łowicki,G.Zduny,1005102,6010,0,6010
Wojewodztwo Łódzkie,Powiat łódzki wschodni,G.Andrespol,1006022,12696,0,12696
Wojewodztwo Łódzkie,Powiat łódzki wschodni,G.Brójce,1006032,5996,0,5996
Wojewodztwo Łódzkie,Powiat łódzki wschodni,M-W.Koluszki,1006073,23536,13555,9981
Wojewodztwo Łódzkie,Powiat łódzki wschodni,G.Nowosolna,1006082,4241,0,4241
Wojewodztwo Łódzkie,Powiat łódzki wschodni,M-W.Rzgów,1006103,9577,3376,6201
Wojewodztwo Łódzkie,Powiat łódzki wschodni,M-W.Tuszyn,1006113,12015,7326,4689
Wojewodztwo Łódzkie,Powiat opoczyński,G.Białaczów,1007012,6019,0,6019
Wojewodztwo Łódzkie,Powiat opoczyński,M-W.Drzewica,1007023,10941,4024,6917
Wojewodztwo Łódzkie,Powiat opoczyński,G.Mniszków,1007032,4744,0,4744
Wojewodztwo Łódzkie,Powiat opoczyński,M-W.Opoczno,1007043,35492,22583,12909
Wojewodztwo Łódzkie,Powiat opoczyński,G.Paradyż,1007052,4470,0,4470
Wojewodztwo Łódzkie,Powiat opoczyński,G.Poświętne,1007062,3320,0,3320
Wojewodztwo Łódzkie,Powiat opoczyński,G.Sławno,1007072,7534,0,7534
Wojewodztwo Łódzkie,Powiat opoczyński,G.Żarnów,1007082,6130,0,6130
Wojewodztwo Łódzkie,Powiat pabianicki,M.Konstantynów Łódzki,1008011,17757,17757,0
Wojewodztwo Łódzkie,Powiat pabianicki,M.Pabianice,1008021,69177,69177,0
Wojewodztwo Łódzkie,Powiat pabianicki,G.Dłutów,1008032,4309,0,4309
Wojewodztwo Łódzkie,Powiat pabianicki,G.Dobroń,1008042,7199,0,7199
Wojewodztwo Łódzkie,Powiat pabianicki,G.Ksawerów,1008052,7458,0,7458
Wojewodztwo Łódzkie,Powiat pabianicki,G.Lutomiersk,1008062,7647,0,7647
Wojewodztwo Łódzkie,Powiat pabianicki,G.Pabianice,1008072,6383,0,6383
Wojewodztwo Łódzkie,Powiat pajęczański,M-W.Działoszyn,1009013,12992,6316,6676
Wojewodztwo Łódzkie,Powiat pajęczański,G.Kiełczygłów,1009022,4265,0,4265
Wojewodztwo Łódzkie,Powiat pajęczański,G.Nowa Brzeźnica,1009032,4804,0,4804
Wojewodztwo Łódzkie,Powiat pajęczański,M-W.Pajęczno,1009043,11767,6797,4970
Wojewodztwo Łódzkie,Powiat pajęczański,G.Rząśnia,1009052,4867,0,4867
Wojewodztwo Łódzkie,Powiat pajęczański,G.Siemkowice,1009062,4875,0,4875
Wojewodztwo Łódzkie,Powiat pajęczański,G.Strzelce Wielkie,1009072,4762,0,4762
Wojewodztwo Łódzkie,Powiat pajęczański,G.Sulmierzyce,1009082,4601,0,4601
Wojewodztwo Łódzkie,Powiat piotrkowski,G.Aleksandrów,1010012,4423,0,4423
Wojewodztwo Łódzkie,Powiat piotrkowski,G.Czarnocin,1010022,4091,0,4091
Wojewodztwo Łódzkie,Powiat piotrkowski,G.Gorzkowice,1010032,8699,0,8699
Wojewodztwo Łódzkie,Powiat piotrkowski,G.Grabica,1010042,6101,0,6101
Wojewodztwo Łódzkie,Powiat piotrkowski,G.Łęki Szlacheckie,1010052,3705,0,3705
Wojewodztwo Łódzkie,Powiat piotrkowski,G.Moszczenica,1010062,12936,0,12936
Wojewodztwo Łódzkie,Powiat piotrkowski,G.Ręczno,1010072,3639,0,3639
Wojewodztwo Łódzkie,Powiat piotrkowski,G.Rozprza,1010082,12183,0,12183
Wojewodztwo Łódzkie,Powiat piotrkowski,M-W.Sulejów,1010093,16166,6461,9705
Wojewodztwo Łódzkie,Powiat piotrkowski,G.Wola Krzysztoporska,1010102,11746,0,11746
Wojewodztwo Łódzkie,Powiat piotrkowski,M-W.Wolbórz,1010113,7728,2348,5380
Wojewodztwo Łódzkie,Powiat poddębicki,G.Dalików,1011012,3839,0,3839
Wojewodztwo Łódzkie,Powiat poddębicki,G.Pęczniew,1011022,3579,0,3579
Wojewodztwo Łódzkie,Powiat poddębicki,M-W.Poddębice,1011033,15907,7812,8095
Wojewodztwo Łódzkie,Powiat poddębicki,M-W.Uniejów,1011043,7283,3019,4264
Wojewodztwo Łódzkie,Powiat poddębicki,G.Wartkowice,1011052,6335,0,6335
Wojewodztwo Łódzkie,Powiat poddębicki,G.Zadzim,1011062,5211,0,5211
Wojewodztwo Łódzkie,Powiat radomszczański,M.Radomsko,1012011,48362,48362,0
Wojewodztwo Łódzkie,Powiat radomszczański,G.Dobryszyce,1012022,4317,0,4317
Wojewodztwo Łódzkie,Powiat radomszczański,G.Gidle,1012032,6434,0,6434
Wojewodztwo Łódzkie,Powiat radomszczański,G.Gomunice,1012042,6034,0,6034
Wojewodztwo Łódzkie,Powiat radomszczański,M-W.Kamieńsk,1012053,6144,2889,3255
Wojewodztwo Łódzkie,Powiat radomszczański,G.Kobiele Wielkie,1012062,4460,0,4460
Wojewodztwo Łódzkie,Powiat radomszczański,G.Kodrąb,1012072,4767,0,4767
Wojewodztwo Łódzkie,Powiat radomszczański,G.Lgota Wielka,1012082,4381,0,4381
Wojewodztwo Łódzkie,Powiat radomszczański,G.Ładzice,1012092,4899,0,4899
Wojewodztwo Łódzkie,Powiat radomszczański,G.Masłowice,1012102,4322,0,4322
Wojewodztwo Łódzkie,Powiat radomszczański,M-W.Przedbórz,1012113,7518,3772,3746
Wojewodztwo Łódzkie,Powiat radomszczański,G.Radomsko,1012122,5651,0,5651
Wojewodztwo Łódzkie,Powiat radomszczański,G.Wielgomłyny,1012132,4864,0,4864
Wojewodztwo Łódzkie,Powiat radomszczański,G.Żytno,1012142,5440,0,5440
Wojewodztwo Łódzkie,Powiat rawski,M.Rawa Mazowiecka,1013011,17845,17845,0
Wojewodztwo Łódzkie,Powiat rawski,M-W.Biała Rawska,1013023,11638,3264,8374
Wojewodztwo Łódzkie,Powiat rawski,G.Cielądz,1013032,4100,0,4100
Wojewodztwo Łódzkie,Powiat rawski,G.Rawa Mazowiecka,1013042,8637,0,8637
Wojewodztwo Łódzkie,Powiat rawski,G.Regnów,1013052,1859,0,1859
Wojewodztwo Łódzkie,Powiat rawski,G.Sadkowice,1013062,5695,0,5695
Wojewodztwo Łódzkie,Powiat sieradzki,M.Sieradz,1014011,43903,43903,0
Wojewodztwo Łódzkie,Powiat sieradzki,M-W.Błaszki,1014023,15036,2327,12709
Wojewodztwo Łódzkie,Powiat sieradzki,G.Brąszewice,1014032,4481,0,4481
Wojewodztwo Łódzkie,Powiat sieradzki,G.Brzeźnio,1014042,6310,0,6310
Wojewodztwo Łódzkie,Powiat sieradzki,G.Burzenin,1014052,5654,0,5654
Wojewodztwo Łódzkie,Powiat sieradzki,G.Goszczanów,1014062,5723,0,5723
Wojewodztwo Łódzkie,Powiat sieradzki,G.Klonowa,1014072,3008,0,3008
Wojewodztwo Łódzkie,Powiat sieradzki,G.Sieradz,1014082,10220,0,10220
Wojewodztwo Łódzkie,Powiat sieradzki,M-W.Warta,1014093,12980,3377,9603
Wojewodztwo Łódzkie,Powiat sieradzki,G.Wróblew,1014102,6138,0,6138
Wojewodztwo Łódzkie,Powiat sieradzki,M-W.Złoczew,1014113,7382,3440,3942
Wojewodztwo Łódzkie,Powiat skierniewicki,G.Bolimów,1015012,4096,0,4096
Wojewodztwo Łódzkie,Powiat skierniewicki,G.Głuchów,1015022,5943,0,5943
Wojewodztwo Łódzkie,Powiat skierniewicki,G.Godzianów,1015032,2644,0,2644
Wojewodztwo Łódzkie,Powiat skierniewicki,G.Kowiesy,1015042,2997,0,2997
Wojewodztwo Łódzkie,Powiat skierniewicki,G.Lipce Reymontowskie,1015052,3318,0,3318
Wojewodztwo Łódzkie,Powiat skierniewicki,G.Maków,1015062,5989,0,5989
Wojewodztwo Łódzkie,Powiat skierniewicki,G.Nowy Kawęczyn,1015072,3353,0,3353
Wojewodztwo Łódzkie,Powiat skierniewicki,G.Skierniewice,1015082,7234,0,7234
Wojewodztwo Łódzkie,Powiat skierniewicki,G.Słupia,1015092,2688,0,2688
Wojewodztwo Łódzkie,Powiat tomaszowski,M.Tomaszów Mazowiecki,1016011,65998,65998,0
Wojewodztwo Łódzkie,Powiat tomaszowski,G.Będków,1016022,3442,0,3442
Wojewodztwo Łódzkie,Powiat tomaszowski,G.Budziszewice,1016032,2260,0,2260
Wojewodztwo Łódzkie,Powiat tomaszowski,G.Czerniewice,1016042,5201,0,5201
Wojewodztwo Łódzkie,Powiat tomaszowski,G.Inowłódz,1016052,3938,0,3938
Wojewodztwo Łódzkie,Powiat tomaszowski,G.Lubochnia,1016062,7577,0,7577
Wojewodztwo Łódzkie,Powiat tomaszowski,G.Rokiciny,1016072,6112,0,6112
Wojewodztwo Łódzkie,Powiat tomaszowski,G.Rzeczyca,1016082,4869,0,4869
Wojewodztwo Łódzkie,Powiat tomaszowski,G.Tomaszów Mazowiecki,1016092,10510,0,10510
Wojewodztwo Łódzkie,Powiat tomaszowski,G.Ujazd,1016102,7904,0,7904
Wojewodztwo Łódzkie,Powiat tomaszowski,G.Żelechlinek,1016112,3395,0,3395
Wojewodztwo Łódzkie,Powiat wieluński,G.Biała,1017012,5587,0,5587
Wojewodztwo Łódzkie,Powiat wieluński,G.Czarnożyły,1017022,4562,0,4562
Wojewodztwo Łódzkie,Powiat wieluński,G.Konopnica,1017032,3896,0,3896
Wojewodztwo Łódzkie,Powiat wieluński,G.Mokrsko,1017042,5395,0,5395
Wojewodztwo Łódzkie,Powiat wieluński,G.Osjaków,1017052,4788,0,4788
Wojewodztwo Łódzkie,Powiat wieluński,G.Ostrówek,1017062,4611,0,4611
Wojewodztwo Łódzkie,Powiat wieluński,G.Pątnów,1017072,6556,0,6556
Wojewodztwo Łódzkie,Powiat wieluński,G.Skomlin,1017082,3413,0,3413
Wojewodztwo Łódzkie,Powiat wieluński,M-W.Wieluń,1017093,32799,24033,8766
Wojewodztwo Łódzkie,Powiat wieluński,G.Wierzchlas,1017102,6590,0,6590
Wojewodztwo Łódzkie,Powiat wieruszowski,G.Bolesławiec,1018012,4099,0,4099
Wojewodztwo Łódzkie,Powiat wieruszowski,G.Czastary,1018022,3981,0,3981
Wojewodztwo Łódzkie,Powiat wieruszowski,G.Galewice,1018032,6244,0,6244
Wojewodztwo Łódzkie,Powiat wieruszowski,G.Lututów,1018042,4685,0,4685
Wojewodztwo Łódzkie,Powiat wieruszowski,G.Łubnice,1018052,4157,0,4157
Wojewodztwo Łódzkie,Powiat wieruszowski,G.Sokolniki,1018062,4895,0,4895
Wojewodztwo Łódzkie,Powiat wieruszowski,M-W.Wieruszów,1018073,14373,8792,5581
Wojewodztwo Łódzkie,Powiat zduńskowolski,M.Zduńska Wola,1019011,44213,44213,0
Wojewodztwo Łódzkie,Powiat zduńskowolski,M-W.Szadek,1019023,7375,2030,5345
Wojewodztwo Łódzkie,Powiat zduńskowolski,G.Zapolice,1019032,4861,0,4861
Wojewodztwo Łódzkie,Powiat zduńskowolski,G.Zduńska Wola,1019042,11712,0,11712
Wojewodztwo Łódzkie,Powiat zgierski,M.Głowno,1020011,15123,15123,0
Wojewodztwo Łódzkie,Powiat zgierski,M.Ozorków,1020021,20507,20507,0
Wojewodztwo Łódzkie,Powiat zgierski,M.Zgierz,1020031,58306,58306,0
Wojewodztwo Łódzkie,Powiat zgierski,M-W.Aleksandrów Łódzki,1020043,28670,21085,7585
Wojewodztwo Łódzkie,Powiat zgierski,G.Głowno,1020052,4884,0,4884
Wojewodztwo Łódzkie,Powiat zgierski,G.Ozorków,1020062,6819,0,6819
Wojewodztwo Łódzkie,Powiat zgierski,G.Parzęczew,1020072,5127,0,5127
Wojewodztwo Łódzkie,Powiat zgierski,M-W.Stryków,1020083,12284,3589,8695
Wojewodztwo Łódzkie,Powiat zgierski,G.Zgierz,1020092,12507,0,12507
Wojewodztwo Łódzkie,Powiat brzeziński,M.Brzeziny,1021011,12543,12543,0
Wojewodztwo Łódzkie,Powiat brzeziński,G.Brzeziny,1021022,5505,0,5505
Wojewodztwo Łódzkie,Powiat brzeziński,G.Dmosin,1021032,4605,0,4605
Wojewodztwo Łódzkie,Powiat brzeziński,G.Jeżów,1021042,3538,0,3538
Wojewodztwo Łódzkie,Powiat brzeziński,G.Rogów,1021052,4768,0,4768
Wojewodztwo Łódzkie,Powiat brzeziński,m. Łódź,1061,728892,728892,0
Wojewodztwo Łódzkie,Powiat brzeziński,m. Piotrków Trybunalski,1062,76717,76717,0
Wojewodztwo Łódzkie,Powiat brzeziński,m. Skierniewice,1063,48622,48622,0
Wojewodztwo Małopolskie,Powiat bocheński,M.Bochnia,1201011,30187,30187,0
Wojewodztwo Małopolskie,Powiat bocheński,G.Bochnia,1201022,18803,0,18803
Wojewodztwo Małopolskie,Powiat bocheński,G.Drwinia,1201032,6463,0,6463
Wojewodztwo Małopolskie,Powiat bocheński,G.Lipnica Murowana,1201042,5552,0,5552
Wojewodztwo Małopolskie,Powiat bocheński,G.Łapanów,1201052,7720,0,7720
Wojewodztwo Małopolskie,Powiat bocheński,M-W.Nowy Wiśnicz,1201063,13293,2754,10539
Wojewodztwo Małopolskie,Powiat bocheński,G.Rzezawa,1201072,10956,0,10956
Wojewodztwo Małopolskie,Powiat bocheński,G.Trzciana,1201082,5214,0,5214
Wojewodztwo Małopolskie,Powiat bocheński,G.Żegocina,1201092,5169,0,5169
Wojewodztwo Małopolskie,Powiat brzeski,G.Borzęcin,1202012,8406,0,8406
Wojewodztwo Małopolskie,Powiat brzeski,M-W.Brzesko,1202023,36297,17278,19019
Wojewodztwo Małopolskie,Powiat brzeski,M-W.Czchów,1202033,9568,2361,7207
Wojewodztwo Małopolskie,Powiat brzeski,G.Dębno,1202042,14318,0,14318
Wojewodztwo Małopolskie,Powiat brzeski,G.Gnojnik,1202052,7667,0,7667
Wojewodztwo Małopolskie,Powiat brzeski,G.Iwkowa,1202062,6200,0,6200
Wojewodztwo Małopolskie,Powiat brzeski,G.Szczurowa,1202072,9769,0,9769
Wojewodztwo Małopolskie,Powiat chrzanowski,M-W.Alwernia,1203013,12725,3393,9332
Wojewodztwo Małopolskie,Powiat chrzanowski,G.Babice,1203022,8958,0,8958
Wojewodztwo Małopolskie,Powiat chrzanowski,M-W.Chrzanów,1203033,48967,38829,10138
Wojewodztwo Małopolskie,Powiat chrzanowski,M-W.Libiąż,1203043,22816,17428,5388
Wojewodztwo Małopolskie,Powiat chrzanowski,M-W.Trzebinia,1203053,34482,20392,14090
Wojewodztwo Małopolskie,Powiat dąbrowski,G.Bolesław,1204012,2840,0,2840
Wojewodztwo Małopolskie,Powiat dąbrowski,M-W.Dąbrowa Tarnowska,1204023,21003,11788,9215
Wojewodztwo Małopolskie,Powiat dąbrowski,G.Gręboszów,1204032,3502,0,3502
Wojewodztwo Małopolskie,Powiat dąbrowski,G.Mędrzechów,1204042,3562,0,3562
Wojewodztwo Małopolskie,Powiat dąbrowski,G.Olesno,1204052,7853,0,7853
Wojewodztwo Małopolskie,Powiat dąbrowski,G.Radgoszcz,1204062,7356,0,7356
Wojewodztwo Małopolskie,Powiat dąbrowski,M-W.Szczucin,1204073,13379,4189,9190
Wojewodztwo Małopolskie,Powiat gorlicki,M.Gorlice,1205011,28819,28819,0
Wojewodztwo Małopolskie,Powiat gorlicki,M-W.Biecz,1205023,17089,4697,12392
Wojewodztwo Małopolskie,Powiat gorlicki,M-W.Bobowa,1205033,9497,3000,6497
Wojewodztwo Małopolskie,Powiat gorlicki,G.Gorlice,1205042,16917,0,16917
Wojewodztwo Małopolskie,Powiat gorlicki,G.Lipinki,1205052,6814,0,6814
Wojewodztwo Małopolskie,Powiat gorlicki,G.Łużna,1205062,8365,0,8365
Wojewodztwo Małopolskie,Powiat gorlicki,G.Moszczenica,1205072,4856,0,4856
Wojewodztwo Małopolskie,Powiat gorlicki,G.Ropa,1205082,5288,0,5288
Wojewodztwo Małopolskie,Powiat gorlicki,G.Sękowa,1205092,4891,0,4891
Wojewodztwo Małopolskie,Powiat gorlicki,G.Uście Gorlickie,1205102,6619,0,6619
Wojewodztwo Małopolskie,Powiat krakowski,G.Czernichów,1206012,13630,0,13630
Wojewodztwo Małopolskie,Powiat krakowski,G.Igołomia-Wawrzeńczyce,1206022,7759,0,7759
Wojewodztwo Małopolskie,Powiat krakowski,G.Iwanowice,1206032,8552,0,8552
Wojewodztwo Małopolskie,Powiat krakowski,G.Jerzmanowice-Przeginia,1206042,10630,0,10630
Wojewodztwo Małopolskie,Powiat krakowski,G.Kocmyrzów-Luborzyca,1206052,14124,0,14124
Wojewodztwo Małopolskie,Powiat krakowski,M-W.Krzeszowice,1206063,32305,10286,22019
Wojewodztwo Małopolskie,Powiat krakowski,G.Liszki,1206072,16179,0,16179
Wojewodztwo Małopolskie,Powiat krakowski,G.Michałowice,1206082,9227,0,9227
Wojewodztwo Małopolskie,Powiat krakowski,G.Mogilany,1206092,12497,0,12497
Wojewodztwo Małopolskie,Powiat krakowski,M-W.Skała,1206103,10052,3719,6333
Wojewodztwo Małopolskie,Powiat krakowski,M-W.Skawina,1206113,42679,24253,18426
Wojewodztwo Małopolskie,Powiat krakowski,M-W.Słomniki,1206123,13789,4434,9355
Wojewodztwo Małopolskie,Powiat krakowski,G.Sułoszowa,1206132,5828,0,5828
Wojewodztwo Małopolskie,Powiat krakowski,M-W.Świątniki Górne,1206143,9291,2280,7011
Wojewodztwo Małopolskie,Powiat krakowski,G.Wielka Wieś,1206152,10363,0,10363
Wojewodztwo Małopolskie,Powiat krakowski,G.Zabierzów,1206162,24220,0,24220
Wojewodztwo Małopolskie,Powiat krakowski,G.Zielonki,1206172,18581,0,18581
Wojewodztwo Małopolskie,Powiat limanowski,M.Limanowa,1207011,15146,15146,0
Wojewodztwo Małopolskie,Powiat limanowski,M.Mszana Dolna,1207021,7792,7792,0
Wojewodztwo Małopolskie,Powiat limanowski,G.Dobra,1207032,9672,0,9672
Wojewodztwo Małopolskie,Powiat limanowski,G.Jodłownik,1207042,8264,0,8264
Wojewodztwo Małopolskie,Powiat limanowski,G.Kamienica,1207052,7647,0,7647
Wojewodztwo Małopolskie,Powiat limanowski,G.Laskowa,1207062,7810,0,7810
Wojewodztwo Małopolskie,Powiat limanowski,G.Limanowa,1207072,24016,0,24016
Wojewodztwo Małopolskie,Powiat limanowski,G.Łukowica,1207082,9639,0,9639
Wojewodztwo Małopolskie,Powiat limanowski,G.Mszana Dolna,1207092,17054,0,17054
Wojewodztwo Małopolskie,Powiat limanowski,G.Niedźwiedź,1207102,7125,0,7125
Wojewodztwo Małopolskie,Powiat limanowski,G.Słopnice,1207112,6264,0,6264
Wojewodztwo Małopolskie,Powiat limanowski,G.Tymbark,1207122,6387,0,6387
Wojewodztwo Małopolskie,Powiat miechowski,G.Charsznica,1208012,7741,0,7741
Wojewodztwo Małopolskie,Powiat miechowski,G.Gołcza,1208022,6234,0,6234
Wojewodztwo Małopolskie,Powiat miechowski,G.Kozłów,1208032,4841,0,4841
Wojewodztwo Małopolskie,Powiat miechowski,G.Książ Wielki,1208042,5355,0,5355
Wojewodztwo Małopolskie,Powiat miechowski,M-W.Miechów,1208053,20022,11927,8095
Wojewodztwo Małopolskie,Powiat miechowski,G.Racławice,1208062,2507,0,2507
Wojewodztwo Małopolskie,Powiat miechowski,G.Słaboszów,1208072,3784,0,3784
Wojewodztwo Małopolskie,Powiat myślenicki,M-W.Dobczyce,1209013,14722,6358,8364
Wojewodztwo Małopolskie,Powiat myślenicki,G.Lubień,1209022,9719,0,9719
Wojewodztwo Małopolskie,Powiat myślenicki,M-W.Myślenice,1209033,42471,18414,24057
Wojewodztwo Małopolskie,Powiat myślenicki,G.Pcim,1209042,10763,0,10763
Wojewodztwo Małopolskie,Powiat myślenicki,G.Raciechowice,1209052,6039,0,6039
Wojewodztwo Małopolskie,Powiat myślenicki,G.Siepraw,1209062,8236,0,8236
Wojewodztwo Małopolskie,Powiat myślenicki,M-W.Sułkowice,1209073,14322,6468,7854
Wojewodztwo Małopolskie,Powiat myślenicki,G.Tokarnia,1209082,8478,0,8478
Wojewodztwo Małopolskie,Powiat myślenicki,G.Wiśniowa,1209092,7047,0,7047
Wojewodztwo Małopolskie,Powiat nowosądecki,M.Grybów,1210011,6261,6261,0
Wojewodztwo Małopolskie,Powiat nowosądecki,G.Chełmiec,1210022,26370,0,26370
Wojewodztwo Małopolskie,Powiat nowosądecki,G.Gródek nad Dunajcem,1210032,9103,0,9103
Wojewodztwo Małopolskie,Powiat nowosądecki,G.Grybów,1210042,23831,0,23831
Wojewodztwo Małopolskie,Powiat nowosądecki,G.Kamionka Wielka,1210052,9746,0,9746
Wojewodztwo Małopolskie,Powiat nowosądecki,G.Korzenna,1210062,13855,0,13855
Wojewodztwo Małopolskie,Powiat nowosądecki,M-W.Krynica-Zdrój,1210073,17111,11361,5750
Wojewodztwo Małopolskie,Powiat nowosądecki,G.Łabowa,1210082,5606,0,5606
Wojewodztwo Małopolskie,Powiat nowosądecki,G.Łącko,1210092,15726,0,15726
Wojewodztwo Małopolskie,Powiat nowosądecki,G.Łososina Dolna,1210102,10433,0,10433
Wojewodztwo Małopolskie,Powiat nowosądecki,M-W.Muszyna,1210113,11683,5123,6560
Wojewodztwo Małopolskie,Powiat nowosądecki,G.Nawojowa,1210122,8152,0,8152
Wojewodztwo Małopolskie,Powiat nowosądecki,M-W.Piwniczna-Zdrój,1210133,10681,5999,4682
Wojewodztwo Małopolskie,Powiat nowosądecki,G.Podegrodzie,1210142,12315,0,12315
Wojewodztwo Małopolskie,Powiat nowosądecki,G.Rytro,1210152,3786,0,3786
Wojewodztwo Małopolskie,Powiat nowosądecki,M-W.Stary Sącz,1210163,23094,9109,13985
Wojewodztwo Małopolskie,Powiat nowotarski,M.Nowy Targ,1211011,33812,33812,0
Wojewodztwo Małopolskie,Powiat nowotarski,M-W.Szczawnica,1211023,7409,5965,1444
Wojewodztwo Małopolskie,Powiat nowotarski,G.Czarny Dunajec,1211032,21884,0,21884
Wojewodztwo Małopolskie,Powiat nowotarski,G.Czorsztyn,1211042,7375,0,7375
Wojewodztwo Małopolskie,Powiat nowotarski,G.Jabłonka,1211052,17707,0,17707
Wojewodztwo Małopolskie,Powiat nowotarski,G.Krościenko nad Dunajcem,1211062,6646,0,6646
Wojewodztwo Małopolskie,Powiat nowotarski,G.Lipnica Wielka,1211072,5907,0,5907
Wojewodztwo Małopolskie,Powiat nowotarski,G.Łapsze Niżne,1211082,9051,0,9051
Wojewodztwo Małopolskie,Powiat nowotarski,G.Nowy Targ,1211092,23172,0,23172
Wojewodztwo Małopolskie,Powiat nowotarski,G.Ochotnica Dolna,1211102,8251,0,8251
Wojewodztwo Małopolskie,Powiat nowotarski,G.Raba Wyżna,1211112,14306,0,14306
Wojewodztwo Małopolskie,Powiat nowotarski,M-W.Rabka-Zdrój,1211123,17527,13278,4249
Wojewodztwo Małopolskie,Powiat nowotarski,G.Spytkowice,1211132,4335,0,4335
Wojewodztwo Małopolskie,Powiat nowotarski,G.Szaflary,1211142,10600,0,10600
Wojewodztwo Małopolskie,Powiat olkuski,M.Bukowno,1212011,10509,10509,0
Wojewodztwo Małopolskie,Powiat olkuski,G.Bolesław,1212032,7905,0,7905
Wojewodztwo Małopolskie,Powiat olkuski,G.Klucze,1212042,15265,0,15265
Wojewodztwo Małopolskie,Powiat olkuski,M-W.Olkusz,1212053,50502,37319,13183
Wojewodztwo Małopolskie,Powiat olkuski,G.Trzyciąż,1212062,7126,0,7126
Wojewodztwo Małopolskie,Powiat olkuski,M-W.Wolbrom,1212073,23525,9013,14512
Wojewodztwo Małopolskie,Powiat oświęcimski,M.Oświęcim,1213011,40342,40342,0
Wojewodztwo Małopolskie,Powiat oświęcimski,M-W.Brzeszcze,1213023,21718,11798,9920
Wojewodztwo Małopolskie,Powiat oświęcimski,M-W.Chełmek,1213033,13056,9223,3833
Wojewodztwo Małopolskie,Powiat oświęcimski,M-W.Kęty,1213043,34112,19198,14914
Wojewodztwo Małopolskie,Powiat oświęcimski,G.Osiek,1213052,8046,0,8046
Wojewodztwo Małopolskie,Powiat oświęcimski,G.Oświęcim,1213062,17512,0,17512
Wojewodztwo Małopolskie,Powiat oświęcimski,G.Polanka Wielka,1213072,4249,0,4249
Wojewodztwo Małopolskie,Powiat oświęcimski,G.Przeciszów,1213082,6754,0,6754
Wojewodztwo Małopolskie,Powiat oświęcimski,M-W.Zator,1213093,9209,3706,5503
Wojewodztwo Małopolskie,Powiat proszowicki,G.Koniusza,1214012,8781,0,8781
Wojewodztwo Małopolskie,Powiat proszowicki,G.Koszyce,1214022,5740,0,5740
Wojewodztwo Małopolskie,Powiat proszowicki,M-W.Nowe Brzesko,1214033,5789,1662,4127
Wojewodztwo Małopolskie,Powiat proszowicki,G.Pałecznica,1214042,3685,0,3685
Wojewodztwo Małopolskie,Powiat proszowicki,M-W.Proszowice,1214053,16514,6270,10244
Wojewodztwo Małopolskie,Powiat proszowicki,G.Radziemice,1214062,3469,0,3469
Wojewodztwo Małopolskie,Powiat suski,M.Jordanów,1215011,5299,5299,0
Wojewodztwo Małopolskie,Powiat suski,M.Sucha Beskidzka,1215021,9557,9557,0
Wojewodztwo Małopolskie,Powiat suski,G.Budzów,1215032,8616,0,8616
Wojewodztwo Małopolskie,Powiat suski,G.Bystra-Sidzina,1215042,6700,0,6700
Wojewodztwo Małopolskie,Powiat suski,G.Jordanów,1215052,10782,0,10782
Wojewodztwo Małopolskie,Powiat suski,M-W.Maków Podhalański,1215063,16326,6072,10254
Wojewodztwo Małopolskie,Powiat suski,G.Stryszawa,1215072,11807,0,11807
Wojewodztwo Małopolskie,Powiat suski,G.Zawoja,1215082,9106,0,9106
Wojewodztwo Małopolskie,Powiat suski,G.Zembrzyce,1215092,5636,0,5636
Wojewodztwo Małopolskie,Powiat tarnowski,M-W.Ciężkowice,1216013,11211,2505,8706
Wojewodztwo Małopolskie,Powiat tarnowski,G.Gromnik,1216022,8699,0,8699
Wojewodztwo Małopolskie,Powiat tarnowski,G.Lisia Góra,1216032,14389,0,14389
Wojewodztwo Małopolskie,Powiat tarnowski,G.Pleśna,1216042,11858,0,11858
Wojewodztwo Małopolskie,Powiat tarnowski,M-W.Radłów,1216053,9751,2724,7027
Wojewodztwo Małopolskie,Powiat tarnowski,M-W.Ryglice,1216063,11694,2878,8816
Wojewodztwo Małopolskie,Powiat tarnowski,G.Rzepiennik Strzyżewski,1216072,6861,0,6861
Wojewodztwo Małopolskie,Powiat tarnowski,G.Skrzyszów,1216082,13580,0,13580
Wojewodztwo Małopolskie,Powiat tarnowski,G.Tarnów,1216092,24342,0,24342
Wojewodztwo Małopolskie,Powiat tarnowski,M-W.Tuchów,1216103,18044,6681,11363
Wojewodztwo Małopolskie,Powiat tarnowski,G.Wierzchosławice,1216112,10588,0,10588
Wojewodztwo Małopolskie,Powiat tarnowski,G.Wietrzychowice,1216122,4112,0,4112
Wojewodztwo Małopolskie,Powiat tarnowski,M-W.Wojnicz,1216133,13220,3386,9834
Wojewodztwo Małopolskie,Powiat tarnowski,M-W.Zakliczyn,1216143,12354,1603,10751
Wojewodztwo Małopolskie,Powiat tarnowski,M-W.Żabno,1216153,18996,4260,14736
Wojewodztwo Małopolskie,Powiat tarnowski,G.Szerzyny,1216162,8092,0,8092
Wojewodztwo Małopolskie,Powiat tatrzański,M.Zakopane,1217011,27857,27857,0
Wojewodztwo Małopolskie,Powiat tatrzański,G.Biały Dunajec,1217022,6989,0,6989
Wojewodztwo Małopolskie,Powiat tatrzański,G.Bukowina Tatrzańska,1217032,12884,0,12884
Wojewodztwo Małopolskie,Powiat tatrzański,G.Kościelisko,1217042,8448,0,8448
Wojewodztwo Małopolskie,Powiat tatrzański,G.Poronin,1217052,11195,0,11195
Wojewodztwo Małopolskie,Powiat wadowicki,M-W.Andrychów,1218013,43859,21530,22329
Wojewodztwo Małopolskie,Powiat wadowicki,G.Brzeźnica,1218022,9908,0,9908
Wojewodztwo Małopolskie,Powiat wadowicki,M-W.Kalwaria Zebrzydowska,1218033,19705,4587,15118
Wojewodztwo Małopolskie,Powiat wadowicki,G.Lanckorona,1218042,6077,0,6077
Wojewodztwo Małopolskie,Powiat wadowicki,G.Mucharz,1218052,3979,0,3979
Wojewodztwo Małopolskie,Powiat wadowicki,G.Spytkowice,1218062,10108,0,10108
Wojewodztwo Małopolskie,Powiat wadowicki,G.Stryszów,1218072,6791,0,6791
Wojewodztwo Małopolskie,Powiat wadowicki,G.Tomice,1218082,7677,0,7677
Wojewodztwo Małopolskie,Powiat wadowicki,M-W.Wadowice,1218093,37992,19386,18606
Wojewodztwo Małopolskie,Powiat wadowicki,G.Wieprz,1218102,11921,0,11921
Wojewodztwo Małopolskie,Powiat wielicki,G.Biskupice,1219012,9267,0,9267
Wojewodztwo Małopolskie,Powiat wielicki,G.Gdów,1219022,17041,0,17041
Wojewodztwo Małopolskie,Powiat wielicki,G.Kłaj,1219032,10333,0,10333
Wojewodztwo Małopolskie,Powiat wielicki,M-W.Niepołomice,1219043,24320,9987,14333
Wojewodztwo Małopolskie,Powiat wielicki,M-W.Wieliczka,1219053,53020,20559,32461
Wojewodztwo Małopolskie,Powiat wielicki,m. Kraków,1261,757611,757611,0
Wojewodztwo Małopolskie,Powiat wielicki,m. Nowy Sącz,1262,84290,84290,0
Wojewodztwo Małopolskie,Powiat wielicki,m. Tarnów,1263,114053,114053,0
Wojewodztwo Mazowieckie,Powiat białobrzeski,M-W.Białobrzegi,1401013,10429,7263,3166
Wojewodztwo Mazowieckie,Powiat białobrzeski,G.Promna,1401022,5688,0,5688
Wojewodztwo Mazowieckie,Powiat białobrzeski,G.Radzanów,1401032,3946,0,3946
Wojewodztwo Mazowieckie,Powiat białobrzeski,G.Stara Błotnica,1401042,5222,0,5222
Wojewodztwo Mazowieckie,Powiat białobrzeski,G.Stromiec,1401052,5757,0,5757
Wojewodztwo Mazowieckie,Powiat białobrzeski,M-W.Wyśmierzyce,1401063,2855,910,1945
Wojewodztwo Mazowieckie,Powiat ciechanowski,M.Ciechanów,1402011,45481,45481,0
Wojewodztwo Mazowieckie,Powiat ciechanowski,G.Ciechanów,1402022,6613,0,6613
Wojewodztwo Mazowieckie,Powiat ciechanowski,M-W.Glinojeck,1402033,8169,3181,4988
Wojewodztwo Mazowieckie,Powiat ciechanowski,G.Gołymin-Ośrodek,1402042,4009,0,4009
Wojewodztwo Mazowieckie,Powiat ciechanowski,G.Grudusk,1402052,3916,0,3916
Wojewodztwo Mazowieckie,Powiat ciechanowski,G.Ojrzeń,1402062,4369,0,4369
Wojewodztwo Mazowieckie,Powiat ciechanowski,G.Opinogóra Górna,1402072,5965,0,5965
Wojewodztwo Mazowieckie,Powiat ciechanowski,G.Regimin,1402082,5065,0,5065
Wojewodztwo Mazowieckie,Powiat ciechanowski,G.Sońsk,1402092,7984,0,7984
Wojewodztwo Mazowieckie,Powiat garwoliński,M.Garwolin,1403011,16999,16999,0
Wojewodztwo Mazowieckie,Powiat garwoliński,M.Łaskarzew,1403021,4954,4954,0
Wojewodztwo Mazowieckie,Powiat garwoliński,G.Borowie,1403032,5233,0,5233
Wojewodztwo Mazowieckie,Powiat garwoliński,G.Garwolin,1403042,12572,0,12572
Wojewodztwo Mazowieckie,Powiat garwoliński,G.Górzno,1403052,6304,0,6304
Wojewodztwo Mazowieckie,Powiat garwoliński,G.Łaskarzew,1403062,5439,0,5439
Wojewodztwo Mazowieckie,Powiat garwoliński,G.Maciejowice,1403072,7307,0,7307
Wojewodztwo Mazowieckie,Powiat garwoliński,G.Miastków Kościelny,1403082,5048,0,5048
Wojewodztwo Mazowieckie,Powiat garwoliński,G.Parysów,1403092,4115,0,4115
Wojewodztwo Mazowieckie,Powiat garwoliński,M-W.Pilawa,1403103,10685,4334,6351
Wojewodztwo Mazowieckie,Powiat garwoliński,G.Sobolew,1403112,8326,0,8326
Wojewodztwo Mazowieckie,Powiat garwoliński,G.Trojanów,1403122,7582,0,7582
Wojewodztwo Mazowieckie,Powiat garwoliński,G.Wilga,1403132,5352,0,5352
Wojewodztwo Mazowieckie,Powiat garwoliński,M-W.Żelechów,1403143,8495,4155,4340
Wojewodztwo Mazowieckie,Powiat gostyniński,M.Gostynin,1404011,19344,19344,0
Wojewodztwo Mazowieckie,Powiat gostyniński,G.Gostynin,1404022,12207,0,12207
Wojewodztwo Mazowieckie,Powiat gostyniński,G.Pacyna,1404032,3819,0,3819
Wojewodztwo Mazowieckie,Powiat gostyniński,G.Sanniki,1404042,6469,0,6469
Wojewodztwo Mazowieckie,Powiat gostyniński,G.Szczawin Kościelny,1404052,5168,0,5168
Wojewodztwo Mazowieckie,Powiat grodziski,M.Milanówek,1405011,16332,16332,0
Wojewodztwo Mazowieckie,Powiat grodziski,M.Podkowa Leśna,1405021,3952,3952,0
Wojewodztwo Mazowieckie,Powiat grodziski,G.Baranów,1405032,4966,0,4966
Wojewodztwo Mazowieckie,Powiat grodziski,M-W.Grodzisk Mazowiecki,1405043,42178,29363,12815
Wojewodztwo Mazowieckie,Powiat grodziski,G.Jaktorów,1405052,10811,0,10811
Wojewodztwo Mazowieckie,Powiat grodziski,G.Żabia Wola,1405062,7384,0,7384
Wojewodztwo Mazowieckie,Powiat grójecki,G.Belsk Duży,1406012,6682,0,6682
Wojewodztwo Mazowieckie,Powiat grójecki,G.Błędów,1406022,7824,0,7824
Wojewodztwo Mazowieckie,Powiat grójecki,G.Chynów,1406032,9639,0,9639
Wojewodztwo Mazowieckie,Powiat grójecki,G.Goszczyn,1406042,2980,0,2980
Wojewodztwo Mazowieckie,Powiat grójecki,M-W.Grójec,1406053,24827,16197,8630
Wojewodztwo Mazowieckie,Powiat grójecki,G.Jasieniec,1406062,5421,0,5421
Wojewodztwo Mazowieckie,Powiat grójecki,M-W.Mogielnica,1406073,9104,2433,6671
Wojewodztwo Mazowieckie,Powiat grójecki,M-W.Nowe Miasto nad Pilicą,1406083,8336,4030,4306
Wojewodztwo Mazowieckie,Powiat grójecki,G.Pniewy,1406092,4707,0,4707
Wojewodztwo Mazowieckie,Powiat grójecki,M-W.Warka,1406113,19041,11558,7483
Wojewodztwo Mazowieckie,Powiat kozienicki,G.Garbatka-Letnisko,1407012,5295,0,5295
Wojewodztwo Mazowieckie,Powiat kozienicki,G.Głowaczów,1407022,7500,0,7500
Wojewodztwo Mazowieckie,Powiat kozienicki,G.Gniewoszów,1407032,4146,0,4146
Wojewodztwo Mazowieckie,Powiat kozienicki,G.Grabów nad Pilicą,1407042,3927,0,3927
Wojewodztwo Mazowieckie,Powiat kozienicki,M-W.Kozienice,1407053,30866,18682,12184
Wojewodztwo Mazowieckie,Powiat kozienicki,G.Magnuszew,1407062,6741,0,6741
Wojewodztwo Mazowieckie,Powiat kozienicki,G.Sieciechów,1407072,4117,0,4117
Wojewodztwo Mazowieckie,Powiat legionowski,M.Legionowo,1408011,53526,53526,0
Wojewodztwo Mazowieckie,Powiat legionowski,G.Jabłonna,1408022,16429,0,16429
Wojewodztwo Mazowieckie,Powiat legionowski,G.Nieporęt,1408032,12878,0,12878
Wojewodztwo Mazowieckie,Powiat legionowski,M-W.Serock,1408043,12878,3977,8901
Wojewodztwo Mazowieckie,Powiat legionowski,G.Wieliszew,1408052,11361,0,11361
Wojewodztwo Mazowieckie,Powiat lipski,G.Chotcza,1409012,2543,0,2543
Wojewodztwo Mazowieckie,Powiat lipski,G.Ciepielów,1409022,5852,0,5852
Wojewodztwo Mazowieckie,Powiat lipski,M-W.Lipsko,1409033,11639,5925,5714
Wojewodztwo Mazowieckie,Powiat lipski,G.Rzeczniów,1409042,4681,0,4681
Wojewodztwo Mazowieckie,Powiat lipski,G.Sienno,1409052,6201,0,6201
Wojewodztwo Mazowieckie,Powiat lipski,G.Solec nad Wisłą,1409062,5404,0,5404
Wojewodztwo Mazowieckie,Powiat łosicki,G.Huszlew,1410012,3021,0,3021
Wojewodztwo Mazowieckie,Powiat łosicki,M-W.Łosice,1410023,11146,7191,3955
Wojewodztwo Mazowieckie,Powiat łosicki,G.Olszanka,1410032,3131,0,3131
Wojewodztwo Mazowieckie,Powiat łosicki,G.Platerów,1410042,5218,0,5218
Wojewodztwo Mazowieckie,Powiat łosicki,G.Sarnaki,1410052,5080,0,5080
Wojewodztwo Mazowieckie,Powiat łosicki,G.Stara Kornica,1410062,5078,0,5078
Wojewodztwo Mazowieckie,Powiat makowski,M.Maków Mazowiecki,1411011,10268,10268,0
Wojewodztwo Mazowieckie,Powiat makowski,G.Czerwonka,1411022,2675,0,2675
Wojewodztwo Mazowieckie,Powiat makowski,G.Karniewo,1411032,5412,0,5412
Wojewodztwo Mazowieckie,Powiat makowski,G.Krasnosielc,1411042,6650,0,6650
Wojewodztwo Mazowieckie,Powiat makowski,G.Młynarze,1411052,1772,0,1772
Wojewodztwo Mazowieckie,Powiat makowski,G.Płoniawy-Bramura,1411062,5819,0,5819
Wojewodztwo Mazowieckie,Powiat makowski,M-W.Różan,1411073,4517,2767,1750
Wojewodztwo Mazowieckie,Powiat makowski,G.Rzewnie,1411082,2748,0,2748
Wojewodztwo Mazowieckie,Powiat makowski,G.Sypniewo,1411092,3501,0,3501
Wojewodztwo Mazowieckie,Powiat makowski,G.Szelków,1411102,3804,0,3804
Wojewodztwo Mazowieckie,Powiat miński,M.Mińsk Mazowiecki,1412011,39347,39347,0
Wojewodztwo Mazowieckie,Powiat miński,G.Cegłów,1412042,6246,0,6246
Wojewodztwo Mazowieckie,Powiat miński,G.Dębe Wielkie,1412052,9143,0,9143
Wojewodztwo Mazowieckie,Powiat miński,G.Dobre,1412062,6017,0,6017
Wojewodztwo Mazowieckie,Powiat miński,M-W.Halinów,1412073,14237,3525,10712
Wojewodztwo Mazowieckie,Powiat miński,G.Jakubów,1412082,5050,0,5050
Wojewodztwo Mazowieckie,Powiat miński,M-W.Kałuszyn,1412093,6036,2947,3089
Wojewodztwo Mazowieckie,Powiat miński,G.Latowicz,1412102,5508,0,5508
Wojewodztwo Mazowieckie,Powiat miński,G.Mińsk Mazowiecki,1412112,13977,0,13977
Wojewodztwo Mazowieckie,Powiat miński,G.Mrozy,1412122,8755,0,8755
Wojewodztwo Mazowieckie,Powiat miński,G.Siennica,1412132,7317,0,7317
Wojewodztwo Mazowieckie,Powiat miński,G.Stanisławów,1412142,6497,0,6497
Wojewodztwo Mazowieckie,Powiat miński,M.Sulejówek,1412151,19248,19248,0
Wojewodztwo Mazowieckie,Powiat mławski,M.Mława,1413011,30859,30859,0
Wojewodztwo Mazowieckie,Powiat mławski,G.Dzierzgowo,1413022,3394,0,3394
Wojewodztwo Mazowieckie,Powiat mławski,G.Lipowiec Kościelny,1413032,5016,0,5016
Wojewodztwo Mazowieckie,Powiat mławski,G.Radzanów,1413042,3615,0,3615
Wojewodztwo Mazowieckie,Powiat mławski,G.Strzegowo,1413052,7940,0,7940
Wojewodztwo Mazowieckie,Powiat mławski,G.Stupsk,1413062,5116,0,5116
Wojewodztwo Mazowieckie,Powiat mławski,G.Szreńsk,1413072,4544,0,4544
Wojewodztwo Mazowieckie,Powiat mławski,G.Szydłowo,1413082,4740,0,4740
Wojewodztwo Mazowieckie,Powiat mławski,G.Wieczfnia Kościelna,1413092,4268,0,4268
Wojewodztwo Mazowieckie,Powiat mławski,G.Wiśniewo,1413102,5403,0,5403
Wojewodztwo Mazowieckie,Powiat nowodworski,M.Nowy Dwór Mazowiecki,1414011,28156,28156,0
Wojewodztwo Mazowieckie,Powiat nowodworski,G.Czosnów,1414022,9411,0,9411
Wojewodztwo Mazowieckie,Powiat nowodworski,G.Leoncin,1414032,5372,0,5372
Wojewodztwo Mazowieckie,Powiat nowodworski,M-W.Nasielsk,1414043,19647,7587,12060
Wojewodztwo Mazowieckie,Powiat nowodworski,G.Pomiechówek,1414052,8944,0,8944
Wojewodztwo Mazowieckie,Powiat nowodworski,M-W.Zakroczym,1414063,6254,3290,2964
Wojewodztwo Mazowieckie,Powiat ostrołęcki,G.Baranowo,1415012,6864,0,6864
Wojewodztwo Mazowieckie,Powiat ostrołęcki,G.Czarnia,1415022,2762,0,2762
Wojewodztwo Mazowieckie,Powiat ostrołęcki,G.Czerwin,1415032,5188,0,5188
Wojewodztwo Mazowieckie,Powiat ostrołęcki,G.Goworowo,1415042,8710,0,8710
Wojewodztwo Mazowieckie,Powiat ostrołęcki,G.Kadzidło,1415052,11455,0,11455
Wojewodztwo Mazowieckie,Powiat ostrołęcki,G.Lelis,1415062,8835,0,8835
Wojewodztwo Mazowieckie,Powiat ostrołęcki,G.Łyse,1415072,8390,0,8390
Wojewodztwo Mazowieckie,Powiat ostrołęcki,M-W.Myszyniec,1415083,10620,3127,7493
Wojewodztwo Mazowieckie,Powiat ostrołęcki,G.Olszewo-Borki,1415092,10030,0,10030
Wojewodztwo Mazowieckie,Powiat ostrołęcki,G.Rzekuń,1415102,9641,0,9641
Wojewodztwo Mazowieckie,Powiat ostrołęcki,G.Troszyn,1415112,4925,0,4925
Wojewodztwo Mazowieckie,Powiat ostrowski,M.Ostrów Mazowiecka,1416011,22842,22842,0
Wojewodztwo Mazowieckie,Powiat ostrowski,G.Andrzejewo,1416022,4457,0,4457
Wojewodztwo Mazowieckie,Powiat ostrowski,G.Boguty-Pianki,1416032,2846,0,2846
Wojewodztwo Mazowieckie,Powiat ostrowski,M-W.Brok,1416043,2934,1977,957
Wojewodztwo Mazowieckie,Powiat ostrowski,G.Małkinia Górna,1416052,12221,0,12221
Wojewodztwo Mazowieckie,Powiat ostrowski,G.Nur,1416062,3058,0,3058
Wojewodztwo Mazowieckie,Powiat ostrowski,G.Ostrów Mazowiecka,1416072,12930,0,12930
Wojewodztwo Mazowieckie,Powiat ostrowski,G.Stary Lubotyń,1416082,3957,0,3957
Wojewodztwo Mazowieckie,Powiat ostrowski,G.Szulborze Wielkie,1416092,1828,0,1828
Wojewodztwo Mazowieckie,Powiat ostrowski,G.Wąsewo,1416102,4558,0,4558
Wojewodztwo Mazowieckie,Powiat ostrowski,G.Zaręby Kościelne,1416112,3862,0,3862
Wojewodztwo Mazowieckie,Powiat otwocki,M.Józefów,1417011,19476,19476,0
Wojewodztwo Mazowieckie,Powiat otwocki,M.Otwock,1417021,44808,44808,0
Wojewodztwo Mazowieckie,Powiat otwocki,G.Celestynów,1417032,11409,0,11409
Wojewodztwo Mazowieckie,Powiat otwocki,M-W.Karczew,1417043,15966,10197,5769
Wojewodztwo Mazowieckie,Powiat otwocki,G.Kołbiel,1417052,8066,0,8066
Wojewodztwo Mazowieckie,Powiat otwocki,G.Osieck,1417062,3496,0,3496
Wojewodztwo Mazowieckie,Powiat otwocki,G.Sobienie-Jeziory,1417072,6326,0,6326
Wojewodztwo Mazowieckie,Powiat otwocki,G.Wiązowna,1417082,11036,0,11036
Wojewodztwo Mazowieckie,Powiat piaseczyński,M-W.Góra Kalwaria,1418013,25391,11588,13803
Wojewodztwo Mazowieckie,Powiat piaseczyński,M-W.Konstancin-Jeziorna,1418023,24854,17566,7288
Wojewodztwo Mazowieckie,Powiat piaseczyński,G.Lesznowola,1418032,20791,0,20791
Wojewodztwo Mazowieckie,Powiat piaseczyński,M-W.Piaseczno,1418043,72159,42378,29781
Wojewodztwo Mazowieckie,Powiat piaseczyński,G.Prażmów,1418052,9644,0,9644
Wojewodztwo Mazowieckie,Powiat piaseczyński,M-W.Tarczyn,1418063,11040,4057,6983
Wojewodztwo Mazowieckie,Powiat płocki,G.Bielsk,1419012,9141,0,9141
Wojewodztwo Mazowieckie,Powiat płocki,G.Bodzanów,1419022,8417,0,8417
Wojewodztwo Mazowieckie,Powiat płocki,G.Brudzeń Duży,1419032,8124,0,8124
Wojewodztwo Mazowieckie,Powiat płocki,G.Bulkowo,1419042,5852,0,5852
Wojewodztwo Mazowieckie,Powiat płocki,M-W.Drobin,1419053,8462,3004,5458
Wojewodztwo Mazowieckie,Powiat płocki,M-W.Gąbin,1419063,10975,4147,6828
Wojewodztwo Mazowieckie,Powiat płocki,G.Łąck,1419072,5198,0,5198
Wojewodztwo Mazowieckie,Powiat płocki,G.Mała Wieś,1419082,6275,0,6275
Wojewodztwo Mazowieckie,Powiat płocki,G.Nowy Duninów,1419092,3993,0,3993
Wojewodztwo Mazowieckie,Powiat płocki,G.Radzanowo,1419102,8030,0,8030
Wojewodztwo Mazowieckie,Powiat płocki,G.Słubice,1419112,4622,0,4622
Wojewodztwo Mazowieckie,Powiat płocki,G.Słupno,1419122,6596,0,6596
Wojewodztwo Mazowieckie,Powiat płocki,G.Stara Biała,1419132,10986,0,10986
Wojewodztwo Mazowieckie,Powiat płocki,G.Staroźreby,1419142,7580,0,7580
Wojewodztwo Mazowieckie,Powiat płocki,M-W.Wyszogród,1419153,5889,2761,3128
Wojewodztwo Mazowieckie,Powiat płoński,M.Płońsk,1420011,22565,22565,0
Wojewodztwo Mazowieckie,Powiat płoński,M.Raciąż,1420021,4658,4658,0
Wojewodztwo Mazowieckie,Powiat płoński,G.Baboszewo,1420032,8192,0,8192
Wojewodztwo Mazowieckie,Powiat płoński,G.Czerwińsk nad Wisłą,1420042,7922,0,7922
Wojewodztwo Mazowieckie,Powiat płoński,G.Dzierzążnia,1420052,3894,0,3894
Wojewodztwo Mazowieckie,Powiat płoński,G.Joniec,1420062,2610,0,2610
Wojewodztwo Mazowieckie,Powiat płoński,G.Naruszewo,1420072,6637,0,6637
Wojewodztwo Mazowieckie,Powiat płoński,G.Nowe Miasto,1420082,4813,0,4813
Wojewodztwo Mazowieckie,Powiat płoński,G.Płońsk,1420092,7434,0,7434
Wojewodztwo Mazowieckie,Powiat płoński,G.Raciąż,1420102,8843,0,8843
Wojewodztwo Mazowieckie,Powiat płoński,G.Sochocin,1420112,5969,0,5969
Wojewodztwo Mazowieckie,Powiat płoński,G.Załuski,1420122,5716,0,5716
Wojewodztwo Mazowieckie,Powiat pruszkowski,M.Piastów,1421011,22966,22966,0
Wojewodztwo Mazowieckie,Powiat pruszkowski,M.Pruszków,1421021,58144,58144,0
Wojewodztwo Mazowieckie,Powiat pruszkowski,M-W.Brwinów,1421033,23615,12720,10895
Wojewodztwo Mazowieckie,Powiat pruszkowski,G.Michałowice,1421042,16756,0,16756
Wojewodztwo Mazowieckie,Powiat pruszkowski,G.Nadarzyn,1421052,11728,0,11728
Wojewodztwo Mazowieckie,Powiat pruszkowski,G.Raszyn,1421062,21075,0,21075
Wojewodztwo Mazowieckie,Powiat przasnyski,M.Przasnysz,1422011,17438,17438,0
Wojewodztwo Mazowieckie,Powiat przasnyski,M-W.Chorzele,1422023,10394,2965,7429
Wojewodztwo Mazowieckie,Powiat przasnyski,G.Czernice Borowe,1422032,3947,0,3947
Wojewodztwo Mazowieckie,Powiat przasnyski,G.Jednorożec,1422042,7387,0,7387
Wojewodztwo Mazowieckie,Powiat przasnyski,G.Krasne,1422052,3880,0,3880
Wojewodztwo Mazowieckie,Powiat przasnyski,G.Krzynowłoga Mała,1422062,3654,0,3654
Wojewodztwo Mazowieckie,Powiat przasnyski,G.Przasnysz,1422072,7431,0,7431
Wojewodztwo Mazowieckie,Powiat przysuski,G.Borkowice,1423012,4572,0,4572
Wojewodztwo Mazowieckie,Powiat przysuski,G.Gielniów,1423022,4767,0,4767
Wojewodztwo Mazowieckie,Powiat przysuski,G.Klwów,1423032,3519,0,3519
Wojewodztwo Mazowieckie,Powiat przysuski,G.Odrzywół,1423042,4067,0,4067
Wojewodztwo Mazowieckie,Powiat przysuski,G.Potworów,1423052,4325,0,4325
Wojewodztwo Mazowieckie,Powiat przysuski,M-W.Przysucha,1423063,12576,6304,6272
Wojewodztwo Mazowieckie,Powiat przysuski,G.Rusinów,1423072,4401,0,4401
Wojewodztwo Mazowieckie,Powiat przysuski,G.Wieniawa,1423082,5477,0,5477
Wojewodztwo Mazowieckie,Powiat pułtuski,G.Gzy,1424012,3976,0,3976
Wojewodztwo Mazowieckie,Powiat pułtuski,G.Obryte,1424022,4877,0,4877
Wojewodztwo Mazowieckie,Powiat pułtuski,G.Pokrzywnica,1424032,4865,0,4865
Wojewodztwo Mazowieckie,Powiat pułtuski,M-W.Pułtusk,1424043,23913,19150,4763
Wojewodztwo Mazowieckie,Powiat pułtuski,G.Świercze,1424052,4754,0,4754
Wojewodztwo Mazowieckie,Powiat pułtuski,G.Winnica,1424062,4102,0,4102
Wojewodztwo Mazowieckie,Powiat pułtuski,G.Zatory,1424072,4800,0,4800
Wojewodztwo Mazowieckie,Powiat radomski,M.Pionki,1425011,19840,19840,0
Wojewodztwo Mazowieckie,Powiat radomski,G.Gózd,1425022,8322,0,8322
Wojewodztwo Mazowieckie,Powiat radomski,M-W.Iłża,1425033,15421,5163,10258
Wojewodztwo Mazowieckie,Powiat radomski,G.Jastrzębia,1425042,6675,0,6675
Wojewodztwo Mazowieckie,Powiat radomski,G.Jedlińsk,1425052,13920,0,13920
Wojewodztwo Mazowieckie,Powiat radomski,G.Jedlnia-Letnisko,1425062,12137,0,12137
Wojewodztwo Mazowieckie,Powiat radomski,G.Kowala,1425072,11471,0,11471
Wojewodztwo Mazowieckie,Powiat radomski,G.Pionki,1425082,9999,0,9999
Wojewodztwo Mazowieckie,Powiat radomski,G.Przytyk,1425092,7225,0,7225
Wojewodztwo Mazowieckie,Powiat radomski,M-W.Skaryszew,1425103,13923,4199,9724
Wojewodztwo Mazowieckie,Powiat radomski,G.Wierzbica,1425112,10123,0,10123
Wojewodztwo Mazowieckie,Powiat radomski,G.Wolanów,1425122,8544,0,8544
Wojewodztwo Mazowieckie,Powiat radomski,G.Zakrzew,1425132,12046,0,12046
Wojewodztwo Mazowieckie,Powiat siedlecki,G.Domanice,1426012,2700,0,2700
Wojewodztwo Mazowieckie,Powiat siedlecki,G.Korczew,1426022,2929,0,2929
Wojewodztwo Mazowieckie,Powiat siedlecki,G.Kotuń,1426032,8578,0,8578
Wojewodztwo Mazowieckie,Powiat siedlecki,G.Mokobody,1426042,5196,0,5196
Wojewodztwo Mazowieckie,Powiat siedlecki,M-W.Mordy,1426053,6212,1845,4367
Wojewodztwo Mazowieckie,Powiat siedlecki,G.Paprotnia,1426062,2769,0,2769
Wojewodztwo Mazowieckie,Powiat siedlecki,G.Przesmyki,1426072,3582,0,3582
Wojewodztwo Mazowieckie,Powiat siedlecki,G.Siedlce,1426082,16824,0,16824
Wojewodztwo Mazowieckie,Powiat siedlecki,G.Skórzec,1426092,7493,0,7493
Wojewodztwo Mazowieckie,Powiat siedlecki,G.Suchożebry,1426102,4765,0,4765
Wojewodztwo Mazowieckie,Powiat siedlecki,G.Wiśniew,1426112,5926,0,5926
Wojewodztwo Mazowieckie,Powiat siedlecki,G.Wodynie,1426122,4695,0,4695
Wojewodztwo Mazowieckie,Powiat siedlecki,G.Zbuczyn,1426132,10137,0,10137
Wojewodztwo Mazowieckie,Powiat sierpecki,M.Sierpc,1427011,18818,18818,0
Wojewodztwo Mazowieckie,Powiat sierpecki,G.Gozdowo,1427022,6115,0,6115
Wojewodztwo Mazowieckie,Powiat sierpecki,G.Mochowo,1427032,6169,0,6169
Wojewodztwo Mazowieckie,Powiat sierpecki,G.Rościszewo,1427042,4269,0,4269
Wojewodztwo Mazowieckie,Powiat sierpecki,G.Sierpc,1427052,7032,0,7032
Wojewodztwo Mazowieckie,Powiat sierpecki,G.Szczutowo,1427062,4449,0,4449
Wojewodztwo Mazowieckie,Powiat sierpecki,G.Zawidz,1427072,7012,0,7012
Wojewodztwo Mazowieckie,Powiat sochaczewski,M.Sochaczew,1428011,38141,38141,0
Wojewodztwo Mazowieckie,Powiat sochaczewski,G.Brochów,1428022,4297,0,4297
Wojewodztwo Mazowieckie,Powiat sochaczewski,G.Iłów,1428032,6320,0,6320
Wojewodztwo Mazowieckie,Powiat sochaczewski,G.Młodzieszyn,1428042,5580,0,5580
Wojewodztwo Mazowieckie,Powiat sochaczewski,G.Nowa Sucha,1428052,6286,0,6286
Wojewodztwo Mazowieckie,Powiat sochaczewski,G.Rybno,1428062,3463,0,3463
Wojewodztwo Mazowieckie,Powiat sochaczewski,G.Sochaczew,1428072,9726,0,9726
Wojewodztwo Mazowieckie,Powiat sochaczewski,G.Teresin,1428082,11305,0,11305
Wojewodztwo Mazowieckie,Powiat sokołowski,M.Sokołów Podlaski,1429011,18796,18796,0
Wojewodztwo Mazowieckie,Powiat sokołowski,G.Bielany,1429022,3806,0,3806
Wojewodztwo Mazowieckie,Powiat sokołowski,G.Ceranów,1429032,2416,0,2416
Wojewodztwo Mazowieckie,Powiat sokołowski,G.Jabłonna Lacka,1429042,4945,0,4945
Wojewodztwo Mazowieckie,Powiat sokołowski,M-W.Kosów Lacki,1429053,6622,2195,4427
Wojewodztwo Mazowieckie,Powiat sokołowski,G.Repki,1429062,5755,0,5755
Wojewodztwo Mazowieckie,Powiat sokołowski,G.Sabnie,1429072,3975,0,3975
Wojewodztwo Mazowieckie,Powiat sokołowski,G.Sokołów Podlaski,1429082,6112,0,6112
Wojewodztwo Mazowieckie,Powiat sokołowski,G.Sterdyń,1429092,4464,0,4464
Wojewodztwo Mazowieckie,Powiat szydłowiecki,G.Chlewiska,1430012,6231,0,6231
Wojewodztwo Mazowieckie,Powiat szydłowiecki,G.Jastrząb,1430022,5243,0,5243
Wojewodztwo Mazowieckie,Powiat szydłowiecki,G.Mirów,1430032,3907,0,3907
Wojewodztwo Mazowieckie,Powiat szydłowiecki,G.Orońsko,1430042,5921,0,5921
Wojewodztwo Mazowieckie,Powiat szydłowiecki,M-W.Szydłowiec,1430053,19527,12268,7259
Wojewodztwo Mazowieckie,Powiat warszawski zachodni,M-W.Błonie,1432013,20794,12531,8263
Wojewodztwo Mazowieckie,Powiat warszawski zachodni,G.Izabelin,1432022,10219,0,10219
Wojewodztwo Mazowieckie,Powiat warszawski zachodni,G.Kampinos,1432032,4212,0,4212
Wojewodztwo Mazowieckie,Powiat warszawski zachodni,G.Leszno,1432042,9707,0,9707
Wojewodztwo Mazowieckie,Powiat warszawski zachodni,M-W.Łomianki,1432053,23916,16375,7541
Wojewodztwo Mazowieckie,Powiat warszawski zachodni,M-W.Ożarów Mazowiecki,1432063,21386,9981,11405
Wojewodztwo Mazowieckie,Powiat warszawski zachodni,G.Stare Babice,1432072,16980,0,16980
Wojewodztwo Mazowieckie,Powiat węgrowski,M.Węgrów,1433011,12837,12837,0
Wojewodztwo Mazowieckie,Powiat węgrowski,G.Grębków,1433022,4605,0,4605
Wojewodztwo Mazowieckie,Powiat węgrowski,G.Korytnica,1433032,6635,0,6635
Wojewodztwo Mazowieckie,Powiat węgrowski,G.Liw,1433042,7627,0,7627
Wojewodztwo Mazowieckie,Powiat węgrowski,M-W.Łochów,1433053,17949,6761,11188
Wojewodztwo Mazowieckie,Powiat węgrowski,G.Miedzna,1433062,4104,0,4104
Wojewodztwo Mazowieckie,Powiat węgrowski,G.Sadowne,1433072,6174,0,6174
Wojewodztwo Mazowieckie,Powiat węgrowski,G.Stoczek,1433082,5271,0,5271
Wojewodztwo Mazowieckie,Powiat węgrowski,G.Wierzbno,1433092,3031,0,3031
Wojewodztwo Mazowieckie,Powiat wołomiński,M.Kobyłka,1434011,19940,19940,0
Wojewodztwo Mazowieckie,Powiat wołomiński,M.Marki,1434021,27066,27066,0
Wojewodztwo Mazowieckie,Powiat wołomiński,M.Ząbki,1434031,28857,28857,0
Wojewodztwo Mazowieckie,Powiat wołomiński,M.Zielonka,1434041,17394,17394,0
Wojewodztwo Mazowieckie,Powiat wołomiński,G.Dąbrówka,1434052,7564,0,7564
Wojewodztwo Mazowieckie,Powiat wołomiński,G.Jadów,1434062,7702,0,7702
Wojewodztwo Mazowieckie,Powiat wołomiński,G.Klembów,1434072,9298,0,9298
Wojewodztwo Mazowieckie,Powiat wołomiński,G.Poświętne,1434082,6014,0,6014
Wojewodztwo Mazowieckie,Powiat wołomiński,M-W.Radzymin,1434093,22561,10084,12477
Wojewodztwo Mazowieckie,Powiat wołomiński,G.Strachówka,1434102,2924,0,2924
Wojewodztwo Mazowieckie,Powiat wołomiński,M-W.Tłuszcz,1434113,19218,7806,11412
Wojewodztwo Mazowieckie,Powiat wołomiński,M-W.Wołomin,1434123,51109,37397,13712
Wojewodztwo Mazowieckie,Powiat wyszkowski,G.Brańszczyk,1435012,8495,0,8495
Wojewodztwo Mazowieckie,Powiat wyszkowski,G.Długosiodło,1435022,7934,0,7934
Wojewodztwo Mazowieckie,Powiat wyszkowski,G.Rząśnik,1435032,6948,0,6948
Wojewodztwo Mazowieckie,Powiat wyszkowski,G.Somianka,1435042,5560,0,5560
Wojewodztwo Mazowieckie,Powiat wyszkowski,M-W.Wyszków,1435053,38932,27312,11620
Wojewodztwo Mazowieckie,Powiat wyszkowski,G.Zabrodzie,1435062,5730,0,5730
Wojewodztwo Mazowieckie,Powiat zwoleński,G.Kazanów,1436012,4698,0,4698
Wojewodztwo Mazowieckie,Powiat zwoleński,G.Policzna,1436022,5845,0,5845
Wojewodztwo Mazowieckie,Powiat zwoleński,G.Przyłęk,1436032,6441,0,6441
Wojewodztwo Mazowieckie,Powiat zwoleński,G.Tczów,1436042,4908,0,4908
Wojewodztwo Mazowieckie,Powiat zwoleński,M-W.Zwoleń,1436053,15392,8219,7173
Wojewodztwo Mazowieckie,Powiat żuromiński,M-W.Bieżuń,1437013,5344,1941,3403
Wojewodztwo Mazowieckie,Powiat żuromiński,G.Kuczbork-Osada,1437022,4926,0,4926
Wojewodztwo Mazowieckie,Powiat żuromiński,G.Lubowidz,1437032,7195,0,7195
Wojewodztwo Mazowieckie,Powiat żuromiński,G.Lutocin,1437042,4615,0,4615
Wojewodztwo Mazowieckie,Powiat żuromiński,G.Siemiątkowo,1437052,3701,0,3701
Wojewodztwo Mazowieckie,Powiat żuromiński,M-W.Żuromin,1437063,14770,9032,5738
Wojewodztwo Mazowieckie,Powiat żyrardowski,M.Żyrardów,1438011,41574,41574,0
Wojewodztwo Mazowieckie,Powiat żyrardowski,M-W.Mszczonów,1438023,11499,6369,5130
Wojewodztwo Mazowieckie,Powiat żyrardowski,G.Puszcza Mariańska,1438032,8385,0,8385
Wojewodztwo Mazowieckie,Powiat żyrardowski,G.Radziejowice,1438042,5191,0,5191
Wojewodztwo Mazowieckie,Powiat żyrardowski,G.Wiskitki,1438052,9847,0,9847
Wojewodztwo Mazowieckie,Powiat żyrardowski,m. Ostrołęka,1461,53572,53572,0
Wojewodztwo Mazowieckie,Powiat żyrardowski,m. Płock,1462,124553,124553,0
Wojewodztwo Mazowieckie,Powiat żyrardowski,m. Radom,1463,221287,221287,0
Wojewodztwo Mazowieckie,Powiat żyrardowski,m. Siedlce,1464,76333,76333,0
Wojewodztwo Mazowieckie,Powiat żyrardowski,m. st. Warszawa,1465,1700612,1700612,0
Wojewodztwo Opolskie,Powiat brzeski,M.Brzeg,1601011,37438,37438,0
Wojewodztwo Opolskie,Powiat brzeski,G.Skarbimierz,1601022,7596,0,7596
Wojewodztwo Opolskie,Powiat brzeski,M-W.Grodków,1601033,19847,8892,10955
Wojewodztwo Opolskie,Powiat brzeski,M-W.Lewin Brzeski,1601043,13608,6045,7563
Wojewodztwo Opolskie,Powiat brzeski,G.Lubsza,1601052,8998,0,8998
Wojewodztwo Opolskie,Powiat brzeski,G.Olszanka,1601062,5018,0,5018
Wojewodztwo Opolskie,Powiat głubczycki,M-W.Baborów,1602013,6315,3081,3234
Wojewodztwo Opolskie,Powiat głubczycki,G.Branice,1602022,7115,0,7115
Wojewodztwo Opolskie,Powiat głubczycki,M-W.Głubczyce,1602033,23483,13136,10347
Wojewodztwo Opolskie,Powiat głubczycki,M-W.Kietrz,1602043,11540,6302,5238
Wojewodztwo Opolskie,Powiat kędzierzyńsko-kozielski,M.Kędzierzyn-Koźle,1603011,64153,64153,0
Wojewodztwo Opolskie,Powiat kędzierzyńsko-kozielski,G.Bierawa,1603022,7767,0,7767
Wojewodztwo Opolskie,Powiat kędzierzyńsko-kozielski,G.Cisek,1603032,6006,0,6006
Wojewodztwo Opolskie,Powiat kędzierzyńsko-kozielski,G.Pawłowiczki,1603042,8097,0,8097
Wojewodztwo Opolskie,Powiat kędzierzyńsko-kozielski,G.Polska Cerekiew,1603052,4413,0,4413
Wojewodztwo Opolskie,Powiat kędzierzyńsko-kozielski,G.Reńska Wieś,1603062,8265,0,8265
Wojewodztwo Opolskie,Powiat kluczborski,M-W.Byczyna,1604013,9656,3766,5890
Wojewodztwo Opolskie,Powiat kluczborski,M-W.Kluczbork,1604023,37148,24962,12186
Wojewodztwo Opolskie,Powiat kluczborski,G.Lasowice Wielkie,1604032,7069,0,7069
Wojewodztwo Opolskie,Powiat kluczborski,M-W.Wołczyn,1604043,14167,6119,8048
Wojewodztwo Opolskie,Powiat krapkowicki,M-W.Gogolin,1605013,12467,6512,5955
Wojewodztwo Opolskie,Powiat krapkowicki,M-W.Krapkowice,1605023,23705,17294,6411
Wojewodztwo Opolskie,Powiat krapkowicki,G.Strzeleczki,1605032,7574,0,7574
Wojewodztwo Opolskie,Powiat krapkowicki,G.Walce,1605042,5639,0,5639
Wojewodztwo Opolskie,Powiat krapkowicki,M-W.Zdzieszowice,1605053,16486,12274,4212
Wojewodztwo Opolskie,Powiat namysłowski,G.Domaszowice,1606012,3745,0,3745
Wojewodztwo Opolskie,Powiat namysłowski,M-W.Namysłów,1606023,25769,16070,9699
Wojewodztwo Opolskie,Powiat namysłowski,G.Pokój,1606032,5441,0,5441
Wojewodztwo Opolskie,Powiat namysłowski,G.Świerczów,1606042,3576,0,3576
Wojewodztwo Opolskie,Powiat namysłowski,G.Wilków,1606052,4654,0,4654
Wojewodztwo Opolskie,Powiat nyski,M-W.Głuchołazy,1607013,25240,14560,10680
Wojewodztwo Opolskie,Powiat nyski,G.Kamiennik,1607022,3720,0,3720
Wojewodztwo Opolskie,Powiat nyski,M-W.Korfantów,1607033,9320,1923,7397
Wojewodztwo Opolskie,Powiat nyski,G.Łambinowice,1607042,7882,0,7882
Wojewodztwo Opolskie,Powiat nyski,M-W.Nysa,1607053,58665,45681,12984
Wojewodztwo Opolskie,Powiat nyski,M-W.Otmuchów,1607063,14124,5163,8961
Wojewodztwo Opolskie,Powiat nyski,M-W.Paczków,1607073,13407,8010,5397
Wojewodztwo Opolskie,Powiat nyski,G.Pakosławice,1607082,3765,0,3765
Wojewodztwo Opolskie,Powiat nyski,G.Skoroszyce,1607092,6458,0,6458
Wojewodztwo Opolskie,Powiat oleski,M-W.Dobrodzień,1608013,10110,3864,6246
Wojewodztwo Opolskie,Powiat oleski,M-W.Gorzów Śląski,1608023,7404,2596,4808
Wojewodztwo Opolskie,Powiat oleski,M-W.Olesno,1608033,18166,9648,8518
Wojewodztwo Opolskie,Powiat oleski,M-W.Praszka,1608043,13945,8147,5798
Wojewodztwo Opolskie,Powiat oleski,G.Radłów,1608052,4498,0,4498
Wojewodztwo Opolskie,Powiat oleski,G.Rudniki,1608062,8343,0,8343
Wojewodztwo Opolskie,Powiat oleski,G.Zębowice,1608072,3822,0,3822
Wojewodztwo Opolskie,Powiat opolski,G.Chrząstowice,1609012,6683,0,6683
Wojewodztwo Opolskie,Powiat opolski,G.Dąbrowa,1609022,9478,0,9478
Wojewodztwo Opolskie,Powiat opolski,G.Dobrzeń Wielki,1609032,14376,0,14376
Wojewodztwo Opolskie,Powiat opolski,G.Komprachcice,1609042,10964,0,10964
Wojewodztwo Opolskie,Powiat opolski,G.Łubniany,1609052,9506,0,9506
Wojewodztwo Opolskie,Powiat opolski,G.Murów,1609062,5628,0,5628
Wojewodztwo Opolskie,Powiat opolski,M-W.Niemodlin,1609073,13610,6780,6830
Wojewodztwo Opolskie,Powiat opolski,M-W.Ozimek,1609083,20185,9421,10764
Wojewodztwo Opolskie,Powiat opolski,G.Popielów,1609092,8263,0,8263
Wojewodztwo Opolskie,Powiat opolski,M-W.Prószków,1609103,9818,2621,7197
Wojewodztwo Opolskie,Powiat opolski,G.Tarnów Opolski,1609112,9724,0,9724
Wojewodztwo Opolskie,Powiat opolski,G.Tułowice,1609122,5269,0,5269
Wojewodztwo Opolskie,Powiat opolski,G.Turawa,1609132,9633,0,9633
Wojewodztwo Opolskie,Powiat prudnicki,M-W.Biała,1610013,11059,2536,8523
Wojewodztwo Opolskie,Powiat prudnicki,M-W.Głogówek,1610023,13857,5800,8057
Wojewodztwo Opolskie,Powiat prudnicki,G.Lubrza,1610032,4429,0,4429
Wojewodztwo Opolskie,Powiat prudnicki,M-W.Prudnik,1610043,28493,22256,6237
Wojewodztwo Opolskie,Powiat strzelecki,G.Izbicko,1611012,5363,0,5363
Wojewodztwo Opolskie,Powiat strzelecki,G.Jemielnica,1611022,7188,0,7188
Wojewodztwo Opolskie,Powiat strzelecki,M-W.Kolonowskie,1611033,6081,3416,2665
Wojewodztwo Opolskie,Powiat strzelecki,M-W.Leśnica,1611043,8158,2745,5413
Wojewodztwo Opolskie,Powiat strzelecki,M-W.Strzelce Opolskie,1611053,31827,18868,12959
Wojewodztwo Opolskie,Powiat strzelecki,M-W.Ujazd,1611063,6269,1730,4539
Wojewodztwo Opolskie,Powiat strzelecki,M-W.Zawadzkie,1611073,12103,7784,4319
Wojewodztwo Opolskie,Powiat strzelecki,m. Opole,1661,122625,122625,0
Wojewodztwo Podkarpackie,Powiat bieszczadzki,G.Czarna,1801032,2421,0,2421
Wojewodztwo Podkarpackie,Powiat bieszczadzki,G.Lutowiska,1801052,2161,0,2161
Wojewodztwo Podkarpackie,Powiat bieszczadzki,M-W.Ustrzyki Dolne,1801083,17883,9635,8248
Wojewodztwo Podkarpackie,Powiat brzozowski,M-W.Brzozów,1802013,26687,7676,19011
Wojewodztwo Podkarpackie,Powiat brzozowski,G.Domaradz,1802022,6161,0,6161
Wojewodztwo Podkarpackie,Powiat brzozowski,G.Dydnia,1802032,8223,0,8223
Wojewodztwo Podkarpackie,Powiat brzozowski,G.Haczów,1802042,9339,0,9339
Wojewodztwo Podkarpackie,Powiat brzozowski,G.Jasienica Rosielna,1802052,7606,0,7606
Wojewodztwo Podkarpackie,Powiat brzozowski,G.Nozdrzec,1802062,8523,0,8523
Wojewodztwo Podkarpackie,Powiat dębicki,M.Dębica,1803011,47217,47217,0
Wojewodztwo Podkarpackie,Powiat dębicki,M-W.Brzostek,1803023,13178,2639,10539
Wojewodztwo Podkarpackie,Powiat dębicki,G.Czarna,1803032,12751,0,12751
Wojewodztwo Podkarpackie,Powiat dębicki,G.Dębica,1803042,24917,0,24917
Wojewodztwo Podkarpackie,Powiat dębicki,G.Jodłowa,1803052,5472,0,5472
Wojewodztwo Podkarpackie,Powiat dębicki,M-W.Pilzno,1803063,17711,4682,13029
Wojewodztwo Podkarpackie,Powiat dębicki,G.Żyraków,1803072,13630,0,13630
Wojewodztwo Podkarpackie,Powiat jarosławski,M.Jarosław,1804011,39857,39857,0
Wojewodztwo Podkarpackie,Powiat jarosławski,M.Radymno,1804021,5514,5514,0
Wojewodztwo Podkarpackie,Powiat jarosławski,G.Chłopice,1804032,5613,0,5613
Wojewodztwo Podkarpackie,Powiat jarosławski,G.Jarosław,1804042,12940,0,12940
Wojewodztwo Podkarpackie,Powiat jarosławski,G.Laszki,1804052,7038,0,7038
Wojewodztwo Podkarpackie,Powiat jarosławski,G.Pawłosiów,1804062,8346,0,8346
Wojewodztwo Podkarpackie,Powiat jarosławski,M-W.Pruchnik,1804073,9834,3675,6159
Wojewodztwo Podkarpackie,Powiat jarosławski,G.Radymno,1804082,11507,0,11507
Wojewodztwo Podkarpackie,Powiat jarosławski,G.Rokietnica,1804092,4376,0,4376
Wojewodztwo Podkarpackie,Powiat jarosławski,G.Roźwienica,1804102,6301,0,6301
Wojewodztwo Podkarpackie,Powiat jarosławski,G.Wiązownica,1804112,11454,0,11454
Wojewodztwo Podkarpackie,Powiat jasielski,M.Jasło,1805011,37071,37071,0
Wojewodztwo Podkarpackie,Powiat jasielski,G.Brzyska,1805022,6392,0,6392
Wojewodztwo Podkarpackie,Powiat jasielski,G.Dębowiec,1805032,8573,0,8573
Wojewodztwo Podkarpackie,Powiat jasielski,G.Jasło,1805042,16233,0,16233
Wojewodztwo Podkarpackie,Powiat jasielski,M-W.Kołaczyce,1805053,9072,1467,7605
Wojewodztwo Podkarpackie,Powiat jasielski,G.Krempna,1805062,2009,0,2009
Wojewodztwo Podkarpackie,Powiat jasielski,G.Nowy Żmigród,1805072,9373,0,9373
Wojewodztwo Podkarpackie,Powiat jasielski,G.Osiek Jasielski,1805082,5389,0,5389
Wojewodztwo Podkarpackie,Powiat jasielski,G.Skołyszyn,1805092,12450,0,12450
Wojewodztwo Podkarpackie,Powiat jasielski,G.Tarnowiec,1805112,9172,0,9172
Wojewodztwo Podkarpackie,Powiat kolbuszowski,G.Cmolas,1806012,8058,0,8058
Wojewodztwo Podkarpackie,Powiat kolbuszowski,M-W.Kolbuszowa,1806023,25118,9428,15690
Wojewodztwo Podkarpackie,Powiat kolbuszowski,G.Majdan Królewski,1806032,9930,0,9930
Wojewodztwo Podkarpackie,Powiat kolbuszowski,G.Niwiska,1806042,6007,0,6007
Wojewodztwo Podkarpackie,Powiat kolbuszowski,G.Raniżów,1806052,7204,0,7204
Wojewodztwo Podkarpackie,Powiat kolbuszowski,G.Dzikowiec,1806062,6516,0,6516
Wojewodztwo Podkarpackie,Powiat krośnieński,G.Chorkówka,1807012,13477,0,13477
Wojewodztwo Podkarpackie,Powiat krośnieński,M-W.Dukla,1807023,14855,2198,12657
Wojewodztwo Podkarpackie,Powiat krośnieński,M-W.Iwonicz-Zdrój,1807033,10919,1890,9029
Wojewodztwo Podkarpackie,Powiat krośnieński,M-W.Jedlicze,1807043,15469,5752,9717
Wojewodztwo Podkarpackie,Powiat krośnieński,G.Korczyna,1807052,11003,0,11003
Wojewodztwo Podkarpackie,Powiat krośnieński,G.Krościenko Wyżne,1807062,5426,0,5426
Wojewodztwo Podkarpackie,Powiat krośnieński,G.Miejsce Piastowe,1807072,13554,0,13554
Wojewodztwo Podkarpackie,Powiat krośnieński,M-W.Rymanów,1807083,15682,3699,11983
Wojewodztwo Podkarpackie,Powiat krośnieński,G.Wojaszówka,1807092,9196,0,9196
Wojewodztwo Podkarpackie,Powiat krośnieński,G.Jaśliska,1807102,2100,0,2100
Wojewodztwo Podkarpackie,Powiat leżajski,M.Leżajsk,1808011,14512,14512,0
Wojewodztwo Podkarpackie,Powiat leżajski,G.Grodzisko Dolne,1808022,8118,0,8118
Wojewodztwo Podkarpackie,Powiat leżajski,G.Kuryłówka,1808032,5724,0,5724
Wojewodztwo Podkarpackie,Powiat leżajski,G.Leżajsk,1808042,19990,0,19990
Wojewodztwo Podkarpackie,Powiat leżajski,M-W.Nowa Sarzyna,1808053,21808,6380,15428
Wojewodztwo Podkarpackie,Powiat lubaczowski,M.Lubaczów,1809011,12573,12573,0
Wojewodztwo Podkarpackie,Powiat lubaczowski,M-W.Cieszanów,1809023,7608,1990,5618
Wojewodztwo Podkarpackie,Powiat lubaczowski,G.Horyniec-Zdrój,1809032,5008,0,5008
Wojewodztwo Podkarpackie,Powiat lubaczowski,G.Lubaczów,1809042,9178,0,9178
Wojewodztwo Podkarpackie,Powiat lubaczowski,M-W.Narol,1809053,8429,2099,6330
Wojewodztwo Podkarpackie,Powiat lubaczowski,M-W.Oleszyce,1809063,6579,3152,3427
Wojewodztwo Podkarpackie,Powiat lubaczowski,G.Stary Dzików,1809072,4442,0,4442
Wojewodztwo Podkarpackie,Powiat lubaczowski,G.Wielkie Oczy,1809082,3944,0,3944
Wojewodztwo Podkarpackie,Powiat łańcucki,M.Łańcut,1810011,18184,18184,0
Wojewodztwo Podkarpackie,Powiat łańcucki,G.Białobrzegi,1810022,8334,0,8334
Wojewodztwo Podkarpackie,Powiat łańcucki,G.Czarna,1810032,11111,0,11111
Wojewodztwo Podkarpackie,Powiat łańcucki,G.Łańcut,1810042,21003,0,21003
Wojewodztwo Podkarpackie,Powiat łańcucki,G.Markowa,1810052,6639,0,6639
Wojewodztwo Podkarpackie,Powiat łańcucki,G.Rakszawa,1810062,7246,0,7246
Wojewodztwo Podkarpackie,Powiat łańcucki,G.Żołynia,1810072,6856,0,6856
Wojewodztwo Podkarpackie,Powiat mielecki,M.Mielec,1811011,61549,61549,0
Wojewodztwo Podkarpackie,Powiat mielecki,G.Borowa,1811022,5622,0,5622
Wojewodztwo Podkarpackie,Powiat mielecki,G.Czermin,1811032,6978,0,6978
Wojewodztwo Podkarpackie,Powiat mielecki,G.Gawłuszowice,1811042,2836,0,2836
Wojewodztwo Podkarpackie,Powiat mielecki,G.Mielec,1811052,12806,0,12806
Wojewodztwo Podkarpackie,Powiat mielecki,G.Padew Narodowa,1811062,5424,0,5424
Wojewodztwo Podkarpackie,Powiat mielecki,M-W.Przecław,1811073,11436,1643,9793
Wojewodztwo Podkarpackie,Powiat mielecki,M-W.Radomyśl Wielki,1811083,14039,3037,11002
Wojewodztwo Podkarpackie,Powiat mielecki,G.Tuszów Narodowy,1811092,7802,0,7802
Wojewodztwo Podkarpackie,Powiat mielecki,G.Wadowice Górne,1811102,7488,0,7488
Wojewodztwo Podkarpackie,Powiat niżański,G.Harasiuki,1812012,6338,0,6338
Wojewodztwo Podkarpackie,Powiat niżański,G.Jarocin,1812022,5483,0,5483
Wojewodztwo Podkarpackie,Powiat niżański,G.Jeżowe,1812032,10095,0,10095
Wojewodztwo Podkarpackie,Powiat niżański,G.Krzeszów,1812042,4328,0,4328
Wojewodztwo Podkarpackie,Powiat niżański,M-W.Nisko,1812053,22596,15610,6986
Wojewodztwo Podkarpackie,Powiat niżański,M-W.Rudnik nad Sanem,1812063,10283,6881,3402
Wojewodztwo Podkarpackie,Powiat niżański,M-W.Ulanów,1812073,8689,1493,7196
Wojewodztwo Podkarpackie,Powiat przemyski,G.Bircza,1813012,6719,0,6719
Wojewodztwo Podkarpackie,Powiat przemyski,G.Dubiecko,1813022,9546,0,9546
Wojewodztwo Podkarpackie,Powiat przemyski,G.Fredropol,1813032,5580,0,5580
Wojewodztwo Podkarpackie,Powiat przemyski,G.Krasiczyn,1813042,4954,0,4954
Wojewodztwo Podkarpackie,Powiat przemyski,G.Krzywcza,1813052,4933,0,4933
Wojewodztwo Podkarpackie,Powiat przemyski,G.Medyka,1813062,6387,0,6387
Wojewodztwo Podkarpackie,Powiat przemyski,G.Orły,1813072,8680,0,8680
Wojewodztwo Podkarpackie,Powiat przemyski,G.Przemyśl,1813082,9911,0,9911
Wojewodztwo Podkarpackie,Powiat przemyski,G.Stubno,1813092,4091,0,4091
Wojewodztwo Podkarpackie,Powiat przemyski,G.Żurawica,1813102,12828,0,12828
Wojewodztwo Podkarpackie,Powiat przeworski,M.Przeworsk,1814011,15971,15971,0
Wojewodztwo Podkarpackie,Powiat przeworski,G.Adamówka,1814022,4205,0,4205
Wojewodztwo Podkarpackie,Powiat przeworski,G.Gać,1814032,4657,0,4657
Wojewodztwo Podkarpackie,Powiat przeworski,G.Jawornik Polski,1814042,4667,0,4667
Wojewodztwo Podkarpackie,Powiat przeworski,M-W.Kańczuga,1814053,12635,3229,9406
Wojewodztwo Podkarpackie,Powiat przeworski,G.Przeworsk,1814062,14739,0,14739
Wojewodztwo Podkarpackie,Powiat przeworski,M-W.Sieniawa,1814073,7009,2188,4821
Wojewodztwo Podkarpackie,Powiat przeworski,G.Tryńcza,1814082,8351,0,8351
Wojewodztwo Podkarpackie,Powiat przeworski,G.Zarzecze,1814092,7168,0,7168
Wojewodztwo Podkarpackie,Powiat ropczycko-sędziszowski,G.Iwierzyce,1815012,7527,0,7527
Wojewodztwo Podkarpackie,Powiat ropczycko-sędziszowski,G.Ostrów,1815022,7063,0,7063
Wojewodztwo Podkarpackie,Powiat ropczycko-sędziszowski,M-W.Ropczyce,1815033,26741,15556,11185
Wojewodztwo Podkarpackie,Powiat ropczycko-sędziszowski,M-W.Sędziszów Małopolski,1815043,23228,7435,15793
Wojewodztwo Podkarpackie,Powiat ropczycko-sędziszowski,G.Wielopole Skrzyńskie,1815052,8442,0,8442
Wojewodztwo Podkarpackie,Powiat rzeszowski,M.Dynów,1816011,6228,6228,0
Wojewodztwo Podkarpackie,Powiat rzeszowski,M-W.Błażowa,1816023,10766,2164,8602
Wojewodztwo Podkarpackie,Powiat rzeszowski,M-W.Boguchwała,1816033,18929,5775,13154
Wojewodztwo Podkarpackie,Powiat rzeszowski,G.Chmielnik,1816042,6668,0,6668
Wojewodztwo Podkarpackie,Powiat rzeszowski,G.Dynów,1816052,7146,0,7146
Wojewodztwo Podkarpackie,Powiat rzeszowski,M-W.Głogów Małopolski,1816063,18627,5816,12811
Wojewodztwo Podkarpackie,Powiat rzeszowski,G.Hyżne,1816072,6971,0,6971
Wojewodztwo Podkarpackie,Powiat rzeszowski,G.Kamień,1816082,6990,0,6990
Wojewodztwo Podkarpackie,Powiat rzeszowski,G.Krasne,1816092,10294,0,10294
Wojewodztwo Podkarpackie,Powiat rzeszowski,G.Lubenia,1816102,6524,0,6524
Wojewodztwo Podkarpackie,Powiat rzeszowski,M-W.Sokołów Małopolski,1816113,16925,4058,12867
Wojewodztwo Podkarpackie,Powiat rzeszowski,G.Świlcza,1816122,15923,0,15923
Wojewodztwo Podkarpackie,Powiat rzeszowski,G.Trzebownisko,1816132,19972,0,19972
Wojewodztwo Podkarpackie,Powiat rzeszowski,M-W.Tyczyn,1816143,11041,3496,7545
Wojewodztwo Podkarpackie,Powiat sanocki,M.Sanok,1817011,39511,39511,0
Wojewodztwo Podkarpackie,Powiat sanocki,G.Besko,1817022,4392,0,4392
Wojewodztwo Podkarpackie,Powiat sanocki,G.Bukowsko,1817032,5458,0,5458
Wojewodztwo Podkarpackie,Powiat sanocki,G.Komańcza,1817042,5121,0,5121
Wojewodztwo Podkarpackie,Powiat sanocki,G.Sanok,1817052,17463,0,17463
Wojewodztwo Podkarpackie,Powiat sanocki,G.Tyrawa Wołoska,1817062,1983,0,1983
Wojewodztwo Podkarpackie,Powiat sanocki,M-W.Zagórz,1817073,12996,5090,7906
Wojewodztwo Podkarpackie,Powiat sanocki,G.Zarszyn,1817082,9325,0,9325
Wojewodztwo Podkarpackie,Powiat stalowowolski,M.Stalowa Wola,1818011,65182,65182,0
Wojewodztwo Podkarpackie,Powiat stalowowolski,G.Bojanów,1818022,7405,0,7405
Wojewodztwo Podkarpackie,Powiat stalowowolski,G.Pysznica,1818032,10177,0,10177
Wojewodztwo Podkarpackie,Powiat stalowowolski,G.Radomyśl nad Sanem,1818042,7418,0,7418
Wojewodztwo Podkarpackie,Powiat stalowowolski,G.Zaklików,1818052,8731,0,8731
Wojewodztwo Podkarpackie,Powiat stalowowolski,G.Zaleszany,1818062,10847,0,10847
Wojewodztwo Podkarpackie,Powiat strzyżowski,G.Czudec,1819012,11750,0,11750
Wojewodztwo Podkarpackie,Powiat strzyżowski,G.Frysztak,1819022,10565,0,10565
Wojewodztwo Podkarpackie,Powiat strzyżowski,G.Niebylec,1819032,10694,0,10694
Wojewodztwo Podkarpackie,Powiat strzyżowski,M-W.Strzyżów,1819043,20905,8902,12003
Wojewodztwo Podkarpackie,Powiat strzyżowski,G.Wiśniowa,1819052,8446,0,8446
Wojewodztwo Podkarpackie,Powiat tarnobrzeski,M-W.Baranów Sandomierski,1820013,12196,1522,10674
Wojewodztwo Podkarpackie,Powiat tarnobrzeski,G.Gorzyce,1820022,13636,0,13636
Wojewodztwo Podkarpackie,Powiat tarnobrzeski,G.Grębów,1820032,9793,0,9793
Wojewodztwo Podkarpackie,Powiat tarnobrzeski,M-W.Nowa Dęba,1820043,18667,11582,7085
Wojewodztwo Podkarpackie,Powiat leski,G.Baligród,1821012,3209,0,3209
Wojewodztwo Podkarpackie,Powiat leski,G.Cisna,1821022,1732,0,1732
Wojewodztwo Podkarpackie,Powiat leski,M-W.Lesko,1821033,11643,5778,5865
Wojewodztwo Podkarpackie,Powiat leski,G.Olszanica,1821042,5038,0,5038
Wojewodztwo Podkarpackie,Powiat leski,G.Solina,1821052,5302,0,5302
Wojewodztwo Podkarpackie,Powiat leski,m. Krosno,1861,47471,47471,0
Wojewodztwo Podkarpackie,Powiat leski,m. Przemyśl,1862,65000,65000,0
Wojewodztwo Podkarpackie,Powiat leski,m. Rzeszów,1863,179386,179386,0
Wojewodztwo Podkarpackie,Powiat leski,m. Tarnobrzeg,1864,48821,48821,0
Wojewodztwo Podlaskie,Powiat augustowski,M.Augustów,2001011,30802,30802,0
Wojewodztwo Podlaskie,Powiat augustowski,G.Augustów,2001022,6879,0,6879
Wojewodztwo Podlaskie,Powiat augustowski,G.Bargłów Kościelny,2001032,5809,0,5809
Wojewodztwo Podlaskie,Powiat augustowski,M-W.Lipsk,2001043,5591,2537,3054
Wojewodztwo Podlaskie,Powiat augustowski,G.Nowinka,2001052,2960,0,2960
Wojewodztwo Podlaskie,Powiat augustowski,G.Płaska,2001062,2573,0,2573
Wojewodztwo Podlaskie,Powiat augustowski,G.Sztabin,2001072,5430,0,5430
Wojewodztwo Podlaskie,Powiat białostocki,M-W.Choroszcz,2002013,14022,5688,8334
Wojewodztwo Podlaskie,Powiat białostocki,M-W.Czarna Białostocka,2002023,11859,9769,2090
Wojewodztwo Podlaskie,Powiat białostocki,G.Dobrzyniewo Duże,2002032,8496,0,8496
Wojewodztwo Podlaskie,Powiat białostocki,G.Gródek,2002042,5696,0,5696
Wojewodztwo Podlaskie,Powiat białostocki,G.Juchnowiec Kościelny,2002052,14618,0,14618
Wojewodztwo Podlaskie,Powiat białostocki,M-W.Łapy,2002063,22755,16225,6530
Wojewodztwo Podlaskie,Powiat białostocki,M-W.Michałowo,2002073,7250,3203,4047
Wojewodztwo Podlaskie,Powiat białostocki,G.Poświętne,2002082,3715,0,3715
Wojewodztwo Podlaskie,Powiat białostocki,M-W.Supraśl,2002093,13746,4684,9062
Wojewodztwo Podlaskie,Powiat białostocki,M-W.Suraż,2002103,2068,1000,1068
Wojewodztwo Podlaskie,Powiat białostocki,G.Turośń Kościelna,2002112,5729,0,5729
Wojewodztwo Podlaskie,Powiat białostocki,M-W.Tykocin,2002123,6464,1994,4470
Wojewodztwo Podlaskie,Powiat białostocki,M-W.Wasilków,2002133,14413,10073,4340
Wojewodztwo Podlaskie,Powiat białostocki,M-W.Zabłudów,2002143,9047,2486,6561
Wojewodztwo Podlaskie,Powiat białostocki,G.Zawady,2002152,2950,0,2950
Wojewodztwo Podlaskie,Powiat bielski,M.Bielsk Podlaski,2003011,26679,26679,0
Wojewodztwo Podlaskie,Powiat bielski,M.Brańsk,2003021,3914,3914,0
Wojewodztwo Podlaskie,Powiat bielski,G.Bielsk Podlaski,2003032,7185,0,7185
Wojewodztwo Podlaskie,Powiat bielski,G.Boćki,2003042,4800,0,4800
Wojewodztwo Podlaskie,Powiat bielski,G.Brańsk,2003052,6307,0,6307
Wojewodztwo Podlaskie,Powiat bielski,G.Orla,2003062,3107,0,3107
Wojewodztwo Podlaskie,Powiat bielski,G.Rudka,2003072,2044,0,2044
Wojewodztwo Podlaskie,Powiat bielski,G.Wyszki,2003082,4777,0,4777
Wojewodztwo Podlaskie,Powiat grajewski,M.Grajewo,2004011,22521,22521,0
Wojewodztwo Podlaskie,Powiat grajewski,G.Grajewo,2004022,6069,0,6069
Wojewodztwo Podlaskie,Powiat grajewski,G.Radziłów,2004032,5070,0,5070
Wojewodztwo Podlaskie,Powiat grajewski,M-W.Rajgród,2004043,5526,1672,3854
Wojewodztwo Podlaskie,Powiat grajewski,M-W.Szczuczyn,2004053,6502,3531,2971
Wojewodztwo Podlaskie,Powiat grajewski,G.Wąsosz,2004062,3971,0,3971
Wojewodztwo Podlaskie,Powiat hajnowski,M.Hajnówka,2005011,22274,22274,0
Wojewodztwo Podlaskie,Powiat hajnowski,G.Białowieża,2005022,2301,0,2301
Wojewodztwo Podlaskie,Powiat hajnowski,G.Czeremcha,2005032,3514,0,3514
Wojewodztwo Podlaskie,Powiat hajnowski,G.Czyże,2005042,2361,0,2361
Wojewodztwo Podlaskie,Powiat hajnowski,G.Dubicze Cerkiewne,2005052,1792,0,1792
Wojewodztwo Podlaskie,Powiat hajnowski,G.Hajnówka,2005062,4076,0,4076
Wojewodztwo Podlaskie,Powiat hajnowski,M-W.Kleszczele,2005073,2814,1400,1414
Wojewodztwo Podlaskie,Powiat hajnowski,G.Narew,2005082,3937,0,3937
Wojewodztwo Podlaskie,Powiat hajnowski,G.Narewka,2005092,3898,0,3898
Wojewodztwo Podlaskie,Powiat kolneński,M.Kolno,2006011,10738,10738,0
Wojewodztwo Podlaskie,Powiat kolneński,G.Grabowo,2006022,3669,0,3669
Wojewodztwo Podlaskie,Powiat kolneński,G.Kolno,2006032,8884,0,8884
Wojewodztwo Podlaskie,Powiat kolneński,G.Mały Płock,2006042,5066,0,5066
Wojewodztwo Podlaskie,Powiat kolneński,M-W.Stawiski,2006053,6570,2447,4123
Wojewodztwo Podlaskie,Powiat kolneński,G.Turośl,2006062,5197,0,5197
Wojewodztwo Podlaskie,Powiat łomżyński,M-W.Jedwabne,2007013,5666,1897,3769
Wojewodztwo Podlaskie,Powiat łomżyński,G.Łomża,2007022,10663,0,10663
Wojewodztwo Podlaskie,Powiat łomżyński,G.Miastkowo,2007032,4368,0,4368
Wojewodztwo Podlaskie,Powiat łomżyński,M-W.Nowogród,2007043,4144,2182,1962
Wojewodztwo Podlaskie,Powiat łomżyński,G.Piątnica,2007052,10755,0,10755
Wojewodztwo Podlaskie,Powiat łomżyński,G.Przytuły,2007062,2197,0,2197
Wojewodztwo Podlaskie,Powiat łomżyński,G.Śniadowo,2007072,5619,0,5619
Wojewodztwo Podlaskie,Powiat łomżyński,G.Wizna,2007082,4365,0,4365
Wojewodztwo Podlaskie,Powiat łomżyński,G.Zbójna,2007092,4424,0,4424
Wojewodztwo Podlaskie,Powiat moniecki,M-W.Goniądz,2008013,5216,1937,3279
Wojewodztwo Podlaskie,Powiat moniecki,G.Jasionówka,2008022,2997,0,2997
Wojewodztwo Podlaskie,Powiat moniecki,G.Jaświły,2008032,5456,0,5456
Wojewodztwo Podlaskie,Powiat moniecki,M-W.Knyszyn,2008043,4987,2861,2126
Wojewodztwo Podlaskie,Powiat moniecki,G.Krypno,2008052,4116,0,4116
Wojewodztwo Podlaskie,Powiat moniecki,M-W.Mońki,2008063,15554,10460,5094
Wojewodztwo Podlaskie,Powiat moniecki,G.Trzcianne,2008072,4625,0,4625
Wojewodztwo Podlaskie,Powiat sejneński,M.Sejny,2009011,5709,5709,0
Wojewodztwo Podlaskie,Powiat sejneński,G.Giby,2009022,2923,0,2923
Wojewodztwo Podlaskie,Powiat sejneński,G.Krasnopol,2009032,3985,0,3985
Wojewodztwo Podlaskie,Powiat sejneński,G.Puńsk,2009042,4366,0,4366
Wojewodztwo Podlaskie,Powiat sejneński,G.Sejny,2009052,4156,0,4156
Wojewodztwo Podlaskie,Powiat siemiatycki,M.Siemiatycze,2010011,15034,15034,0
Wojewodztwo Podlaskie,Powiat siemiatycki,M-W.Drohiczyn,2010023,6840,2153,4687
Wojewodztwo Podlaskie,Powiat siemiatycki,G.Dziadkowice,2010032,3012,0,3012
Wojewodztwo Podlaskie,Powiat siemiatycki,G.Grodzisk,2010042,4634,0,4634
Wojewodztwo Podlaskie,Powiat siemiatycki,G.Mielnik,2010052,2594,0,2594
Wojewodztwo Podlaskie,Powiat siemiatycki,G.Milejczyce,2010062,2106,0,2106
Wojewodztwo Podlaskie,Powiat siemiatycki,G.Nurzec-Stacja,2010072,4361,0,4361
Wojewodztwo Podlaskie,Powiat siemiatycki,G.Perlejewo,2010082,3082,0,3082
Wojewodztwo Podlaskie,Powiat siemiatycki,G.Siemiatycze,2010092,6404,0,6404
Wojewodztwo Podlaskie,Powiat sokólski,M-W.Dąbrowa Białostocka,2011013,12578,6104,6474
Wojewodztwo Podlaskie,Powiat sokólski,G.Janów,2011022,4447,0,4447
Wojewodztwo Podlaskie,Powiat sokólski,G.Korycin,2011032,3488,0,3488
Wojewodztwo Podlaskie,Powiat sokólski,M-W.Krynki,2011043,3358,2581,777
Wojewodztwo Podlaskie,Powiat sokólski,G.Kuźnica,2011052,4313,0,4313
Wojewodztwo Podlaskie,Powiat sokólski,G.Nowy Dwór,2011062,2877,0,2877
Wojewodztwo Podlaskie,Powiat sokólski,G.Sidra,2011072,3748,0,3748
Wojewodztwo Podlaskie,Powiat sokólski,M-W.Sokółka,2011083,26698,19054,7644
Wojewodztwo Podlaskie,Powiat sokólski,M-W.Suchowola,2011093,7323,2289,5034
Wojewodztwo Podlaskie,Powiat sokólski,G.Szudziałowo,2011102,3290,0,3290
Wojewodztwo Podlaskie,Powiat suwalski,G.Bakałarzewo,2012012,3099,0,3099
Wojewodztwo Podlaskie,Powiat suwalski,G.Filipów,2012022,4600,0,4600
Wojewodztwo Podlaskie,Powiat suwalski,G.Jeleniewo,2012032,3162,0,3162
Wojewodztwo Podlaskie,Powiat suwalski,G.Przerośl,2012042,3074,0,3074
Wojewodztwo Podlaskie,Powiat suwalski,G.Raczki,2012052,6131,0,6131
Wojewodztwo Podlaskie,Powiat suwalski,G.Rutka-Tartak,2012062,2471,0,2471
Wojewodztwo Podlaskie,Powiat suwalski,G.Suwałki,2012072,7182,0,7182
Wojewodztwo Podlaskie,Powiat suwalski,G.Szypliszki,2012082,3989,0,3989
Wojewodztwo Podlaskie,Powiat suwalski,G.Wiżajny,2012092,2499,0,2499
Wojewodztwo Podlaskie,Powiat wysokomazowiecki,M.Wysokie Mazowieckie,2013011,9516,9516,0
Wojewodztwo Podlaskie,Powiat wysokomazowiecki,M-W.Ciechanowiec,2013023,9269,4937,4332
Wojewodztwo Podlaskie,Powiat wysokomazowiecki,M-W.Czyżew,2013033,6612,2620,3992
Wojewodztwo Podlaskie,Powiat wysokomazowiecki,G.Klukowo,2013042,4620,0,4620
Wojewodztwo Podlaskie,Powiat wysokomazowiecki,G.Kobylin-Borzymy,2013052,3493,0,3493
Wojewodztwo Podlaskie,Powiat wysokomazowiecki,G.Kulesze Kościelne,2013062,3301,0,3301
Wojewodztwo Podlaskie,Powiat wysokomazowiecki,G.Nowe Piekuty,2013072,4112,0,4112
Wojewodztwo Podlaskie,Powiat wysokomazowiecki,G.Sokoły,2013082,5980,0,5980
Wojewodztwo Podlaskie,Powiat wysokomazowiecki,M-W.Szepietowo,2013093,7378,2321,5057
Wojewodztwo Podlaskie,Powiat wysokomazowiecki,G.Wysokie Mazowieckie,2013102,5380,0,5380
Wojewodztwo Podlaskie,Powiat zambrowski,M.Zambrów,2014011,22812,22812,0
Wojewodztwo Podlaskie,Powiat zambrowski,G.Kołaki Kościelne,2014022,2431,0,2431
Wojewodztwo Podlaskie,Powiat zambrowski,G.Rutki,2014032,5983,0,5983
Wojewodztwo Podlaskie,Powiat zambrowski,G.Szumowo,2014042,4988,0,4988
Wojewodztwo Podlaskie,Powiat zambrowski,G.Zambrów,2014052,8927,0,8927
Wojewodztwo Podlaskie,Powiat zambrowski,m. Białystok,2061,294001,294001,0
Wojewodztwo Podlaskie,Powiat zambrowski,m. Łomża,2062,63203,63203,0
Wojewodztwo Podlaskie,Powiat zambrowski,m. Suwałki,2063,69239,69239,0
Wojewodztwo Pomorskie,Powiat bytowski,G.Borzytuchom,2201012,2954,0,2954
Wojewodztwo Pomorskie,Powiat bytowski,M-W.Bytów,2201023,24829,17121,7708
Wojewodztwo Pomorskie,Powiat bytowski,G.Czarna Dąbrówka,2201032,5756,0,5756
Wojewodztwo Pomorskie,Powiat bytowski,G.Kołczygłowy,2201042,4278,0,4278
Wojewodztwo Pomorskie,Powiat bytowski,G.Lipnica,2201052,5070,0,5070
Wojewodztwo Pomorskie,Powiat bytowski,M-W.Miastko,2201063,20211,11127,9084
Wojewodztwo Pomorskie,Powiat bytowski,G.Parchowo,2201072,3571,0,3571
Wojewodztwo Pomorskie,Powiat bytowski,G.Studzienice,2201082,3525,0,3525
Wojewodztwo Pomorskie,Powiat bytowski,G.Trzebielino,2201092,3790,0,3790
Wojewodztwo Pomorskie,Powiat bytowski,G.Tuchomie,2201102,4160,0,4160
Wojewodztwo Pomorskie,Powiat chojnicki,M.Chojnice,2202011,40447,40447,0
Wojewodztwo Pomorskie,Powiat chojnicki,M-W.Brusy,2202023,13971,4973,8998
Wojewodztwo Pomorskie,Powiat chojnicki,G.Chojnice,2202032,17465,0,17465
Wojewodztwo Pomorskie,Powiat chojnicki,M-W.Czersk,2202043,21445,10023,11422
Wojewodztwo Pomorskie,Powiat chojnicki,G.Konarzyny,2202052,2277,0,2277
Wojewodztwo Pomorskie,Powiat człuchowski,M.Człuchów,2203011,14628,14628,0
Wojewodztwo Pomorskie,Powiat człuchowski,M-W.Czarne,2203023,9432,6089,3343
Wojewodztwo Pomorskie,Powiat człuchowski,G.Człuchów,2203032,10592,0,10592
Wojewodztwo Pomorskie,Powiat człuchowski,M-W.Debrzno,2203043,9364,5265,4099
Wojewodztwo Pomorskie,Powiat człuchowski,G.Koczała,2203052,3563,0,3563
Wojewodztwo Pomorskie,Powiat człuchowski,G.Przechlewo,2203062,6324,0,6324
Wojewodztwo Pomorskie,Powiat człuchowski,G.Rzeczenica,2203072,3725,0,3725
Wojewodztwo Pomorskie,Powiat gdański,M.Pruszcz Gdański,2204011,27787,27787,0
Wojewodztwo Pomorskie,Powiat gdański,G.Cedry Wielkie,2204022,6738,0,6738
Wojewodztwo Pomorskie,Powiat gdański,G.Kolbudy,2204032,14356,0,14356
Wojewodztwo Pomorskie,Powiat gdański,G.Pruszcz Gdański,2204042,21412,0,21412
Wojewodztwo Pomorskie,Powiat gdański,G.Przywidz,2204052,5622,0,5622
Wojewodztwo Pomorskie,Powiat gdański,G.Pszczółki,2204062,8478,0,8478
Wojewodztwo Pomorskie,Powiat gdański,G.Suchy Dąb,2204072,4124,0,4124
Wojewodztwo Pomorskie,Powiat gdański,G.Trąbki Wielkie,2204082,10483,0,10483
Wojewodztwo Pomorskie,Powiat kartuski,G.Chmielno,2205012,7058,0,7058
Wojewodztwo Pomorskie,Powiat kartuski,M-W.Kartuzy,2205023,32631,15190,17441
Wojewodztwo Pomorskie,Powiat kartuski,G.Przodkowo,2205032,7887,0,7887
Wojewodztwo Pomorskie,Powiat kartuski,G.Sierakowice,2205042,17988,0,17988
Wojewodztwo Pomorskie,Powiat kartuski,G.Somonino,2205052,9819,0,9819
Wojewodztwo Pomorskie,Powiat kartuski,G.Stężyca,2205062,9576,0,9576
Wojewodztwo Pomorskie,Powiat kartuski,G.Sulęczyno,2205072,5118,0,5118
Wojewodztwo Pomorskie,Powiat kartuski,M-W.Żukowo,2205083,29877,6452,23425
Wojewodztwo Pomorskie,Powiat kościerski,M.Kościerzyna,2206011,23765,23765,0
Wojewodztwo Pomorskie,Powiat kościerski,G.Dziemiany,2206022,4200,0,4200
Wojewodztwo Pomorskie,Powiat kościerski,G.Karsin,2206032,6159,0,6159
Wojewodztwo Pomorskie,Powiat kościerski,G.Kościerzyna,2206042,14898,0,14898
Wojewodztwo Pomorskie,Powiat kościerski,G.Liniewo,2206052,4625,0,4625
Wojewodztwo Pomorskie,Powiat kościerski,G.Lipusz,2206062,3571,0,3571
Wojewodztwo Pomorskie,Powiat kościerski,G.Nowa Karczma,2206072,6659,0,6659
Wojewodztwo Pomorskie,Powiat kościerski,G.Stara Kiszewa,2206082,6597,0,6597
Wojewodztwo Pomorskie,Powiat kwidzyński,M.Kwidzyn,2207011,38632,38632,0
Wojewodztwo Pomorskie,Powiat kwidzyński,G.Gardeja,2207022,8478,0,8478
Wojewodztwo Pomorskie,Powiat kwidzyński,G.Kwidzyn,2207032,10988,0,10988
Wojewodztwo Pomorskie,Powiat kwidzyński,M-W.Prabuty,2207043,13458,8873,4585
Wojewodztwo Pomorskie,Powiat kwidzyński,G.Ryjewo,2207052,5952,0,5952
Wojewodztwo Pomorskie,Powiat kwidzyński,G.Sadlinki,2207062,5869,0,5869
Wojewodztwo Pomorskie,Powiat lęborski,M.Lębork,2208011,35789,35789,0
Wojewodztwo Pomorskie,Powiat lęborski,M.Łeba,2208021,3903,3903,0
Wojewodztwo Pomorskie,Powiat lęborski,G.Cewice,2208032,7330,0,7330
Wojewodztwo Pomorskie,Powiat lęborski,G.Nowa Wieś Lęborska,2208042,13211,0,13211
Wojewodztwo Pomorskie,Powiat lęborski,G.Wicko,2208052,5910,0,5910
Wojewodztwo Pomorskie,Powiat malborski,M.Malbork,2209011,39387,39387,0
Wojewodztwo Pomorskie,Powiat malborski,G.Lichnowy,2209032,4817,0,4817
Wojewodztwo Pomorskie,Powiat malborski,G.Malbork,2209042,4505,0,4505
Wojewodztwo Pomorskie,Powiat malborski,G.Miłoradz,2209062,3398,0,3398
Wojewodztwo Pomorskie,Powiat malborski,M-W.Nowy Staw,2209073,7994,4486,3508
Wojewodztwo Pomorskie,Powiat malborski,G.Stare Pole,2209082,4726,0,4726
Wojewodztwo Pomorskie,Powiat nowodworski,M.Krynica Morska,2210011,1364,1364,0
Wojewodztwo Pomorskie,Powiat nowodworski,M-W.Nowy Dwór Gdański,2210023,18289,10197,8092
Wojewodztwo Pomorskie,Powiat nowodworski,G.Ostaszewo,2210032,3285,0,3285
Wojewodztwo Pomorskie,Powiat nowodworski,G.Stegna,2210042,9925,0,9925
Wojewodztwo Pomorskie,Powiat nowodworski,G.Sztutowo,2210052,3659,0,3659
Wojewodztwo Pomorskie,Powiat pucki,M.Hel,2211011,3916,3916,0
Wojewodztwo Pomorskie,Powiat pucki,M.Jastarnia,2211021,3970,3970,0
Wojewodztwo Pomorskie,Powiat pucki,M.Puck,2211031,11549,11549,0
Wojewodztwo Pomorskie,Powiat pucki,M.Władysławowo,2211041,15296,15296,0
Wojewodztwo Pomorskie,Powiat pucki,G.Kosakowo,2211052,10223,0,10223
Wojewodztwo Pomorskie,Powiat pucki,G.Krokowa,2211062,10470,0,10470
Wojewodztwo Pomorskie,Powiat pucki,G.Puck,2211072,23923,0,23923
Wojewodztwo Pomorskie,Powiat słupski,M.Ustka,2212011,16560,16560,0
Wojewodztwo Pomorskie,Powiat słupski,G.Damnica,2212022,6264,0,6264
Wojewodztwo Pomorskie,Powiat słupski,G.Dębnica Kaszubska,2212032,9823,0,9823
Wojewodztwo Pomorskie,Powiat słupski,G.Główczyce,2212042,9623,0,9623
Wojewodztwo Pomorskie,Powiat słupski,M-W.Kępice,2212053,9569,3847,5722
Wojewodztwo Pomorskie,Powiat słupski,G.Kobylnica,2212062,10643,0,10643
Wojewodztwo Pomorskie,Powiat słupski,G.Potęgowo,2212072,7184,0,7184
Wojewodztwo Pomorskie,Powiat słupski,G.Słupsk,2212082,15533,0,15533
Wojewodztwo Pomorskie,Powiat słupski,G.Smołdzino,2212092,3455,0,3455
Wojewodztwo Pomorskie,Powiat słupski,G.Ustka,2212102,7994,0,7994
Wojewodztwo Pomorskie,Powiat starogardzki,M.Czarna Woda,2213011,3312,3312,0
Wojewodztwo Pomorskie,Powiat starogardzki,M.Skórcz,2213021,3589,3589,0
Wojewodztwo Pomorskie,Powiat starogardzki,M.Starogard Gdański,2213031,49191,49191,0
Wojewodztwo Pomorskie,Powiat starogardzki,G.Bobowo,2213042,3038,0,3038
Wojewodztwo Pomorskie,Powiat starogardzki,G.Kaliska,2213052,5238,0,5238
Wojewodztwo Pomorskie,Powiat starogardzki,G.Lubichowo,2213062,6148,0,6148
Wojewodztwo Pomorskie,Powiat starogardzki,G.Osieczna,2213072,2942,0,2942
Wojewodztwo Pomorskie,Powiat starogardzki,G.Osiek,2213082,2466,0,2466
Wojewodztwo Pomorskie,Powiat starogardzki,M-W.Skarszewy,2213093,14561,7185,7376
Wojewodztwo Pomorskie,Powiat starogardzki,G.Skórcz,2213102,4653,0,4653
Wojewodztwo Pomorskie,Powiat starogardzki,G.Smętowo Graniczne,2213112,5356,0,5356
Wojewodztwo Pomorskie,Powiat starogardzki,G.Starogard Gdański,2213122,14849,0,14849
Wojewodztwo Pomorskie,Powiat starogardzki,G.Zblewo,2213132,11215,0,11215
Wojewodztwo Pomorskie,Powiat tczewski,M.Tczew,2214011,60889,60889,0
Wojewodztwo Pomorskie,Powiat tczewski,M-W.Gniew,2214023,16059,6899,9160
Wojewodztwo Pomorskie,Powiat tczewski,G.Morzeszczyn,2214032,3763,0,3763
Wojewodztwo Pomorskie,Powiat tczewski,M-W.Pelplin,2214043,16702,8286,8416
Wojewodztwo Pomorskie,Powiat tczewski,G.Subkowy,2214052,5387,0,5387
Wojewodztwo Pomorskie,Powiat tczewski,G.Tczew,2214062,12840,0,12840
Wojewodztwo Pomorskie,Powiat wejherowski,M.Reda,2215011,21579,21579,0
Wojewodztwo Pomorskie,Powiat wejherowski,M.Rumia,2215021,46714,46714,0
Wojewodztwo Pomorskie,Powiat wejherowski,M.Wejherowo,2215031,49922,49922,0
Wojewodztwo Pomorskie,Powiat wejherowski,G.Choczewo,2215042,5718,0,5718
Wojewodztwo Pomorskie,Powiat wejherowski,G.Gniewino,2215052,7143,0,7143
Wojewodztwo Pomorskie,Powiat wejherowski,G.Linia,2215062,5980,0,5980
Wojewodztwo Pomorskie,Powiat wejherowski,G.Luzino,2215072,14253,0,14253
Wojewodztwo Pomorskie,Powiat wejherowski,G.Łęczyce,2215082,11751,0,11751
Wojewodztwo Pomorskie,Powiat wejherowski,G.Szemud,2215092,15067,0,15067
Wojewodztwo Pomorskie,Powiat wejherowski,G.Wejherowo,2215102,21437,0,21437
Wojewodztwo Pomorskie,Powiat sztumski,M-W.Dzierzgoń,2216013,9647,5654,3993
Wojewodztwo Pomorskie,Powiat sztumski,G.Mikołajki Pomorskie,2216022,3774,0,3774
Wojewodztwo Pomorskie,Powiat sztumski,G.Stary Dzierzgoń,2216032,4183,0,4183
Wojewodztwo Pomorskie,Powiat sztumski,G.Stary Targ,2216042,6488,0,6488
Wojewodztwo Pomorskie,Powiat sztumski,M-W.Sztum,2216053,18666,10427,8239
Wojewodztwo Pomorskie,Powiat sztumski,m. Gdańsk,2261,460276,460276,0
Wojewodztwo Pomorskie,Powiat sztumski,m. Gdynia,2262,249139,249139,0
Wojewodztwo Pomorskie,Powiat sztumski,m. Słupsk,2263,95882,95882,0
Wojewodztwo Pomorskie,Powiat sztumski,m. Sopot,2264,38690,38690,0
Wojewodztwo Śląskie,Powiat będziński,M.Będzin,2401011,59069,59069,0
Wojewodztwo Śląskie,Powiat będziński,M.Czeladź,2401021,33745,33745,0
Wojewodztwo Śląskie,Powiat będziński,M.Wojkowice,2401031,9233,9233,0
Wojewodztwo Śląskie,Powiat będziński,G.Bobrowniki,2401042,11648,0,11648
Wojewodztwo Śląskie,Powiat będziński,G.Mierzęcice,2401052,7538,0,7538
Wojewodztwo Śląskie,Powiat będziński,G.Psary,2401062,11583,0,11583
Wojewodztwo Śląskie,Powiat będziński,M-W.Siewierz,2401073,12230,5514,6716
Wojewodztwo Śląskie,Powiat będziński,M.Sławków,2401081,7088,7088,0
Wojewodztwo Śląskie,Powiat bielski,M.Szczyrk,2402011,5801,5801,0
Wojewodztwo Śląskie,Powiat bielski,G.Bestwina,2402022,10844,0,10844
Wojewodztwo Śląskie,Powiat bielski,G.Buczkowice,2402032,10908,0,10908
Wojewodztwo Śląskie,Powiat bielski,M-W.Czechowice-Dziedzice,2402043,44252,35445,8807
Wojewodztwo Śląskie,Powiat bielski,G.Jasienica,2402052,22127,0,22127
Wojewodztwo Śląskie,Powiat bielski,G.Jaworze,2402062,6786,0,6786
Wojewodztwo Śląskie,Powiat bielski,G.Kozy,2402072,12271,0,12271
Wojewodztwo Śląskie,Powiat bielski,G.Porąbka,2402082,15295,0,15295
Wojewodztwo Śląskie,Powiat bielski,M-W.Wilamowice,2402093,16096,2958,13138
Wojewodztwo Śląskie,Powiat bielski,G.Wilkowice,2402102,12947,0,12947
Wojewodztwo Śląskie,Powiat cieszyński,M.Cieszyn,2403011,36248,36248,0
Wojewodztwo Śląskie,Powiat cieszyński,M.Ustroń,2403021,15956,15956,0
Wojewodztwo Śląskie,Powiat cieszyński,M.Wisła,2403031,11335,11335,0
Wojewodztwo Śląskie,Powiat cieszyński,G.Brenna,2403042,10801,0,10801
Wojewodztwo Śląskie,Powiat cieszyński,G.Chybie,2403052,9398,0,9398
Wojewodztwo Śląskie,Powiat cieszyński,G.Dębowiec,2403062,5609,0,5609
Wojewodztwo Śląskie,Powiat cieszyński,G.Goleszów,2403072,12669,0,12669
Wojewodztwo Śląskie,Powiat cieszyński,G.Hażlach,2403082,10386,0,10386
Wojewodztwo Śląskie,Powiat cieszyński,G.Istebna,2403092,11759,0,11759
Wojewodztwo Śląskie,Powiat cieszyński,M-W.Skoczów,2403103,26453,14892,11561
Wojewodztwo Śląskie,Powiat cieszyński,M-W.Strumień,2403113,12486,3557,8929
Wojewodztwo Śląskie,Powiat cieszyński,G.Zebrzydowice,2403122,12962,0,12962
Wojewodztwo Śląskie,Powiat częstochowski,M-W.Blachownia,2404013,13332,9941,3391
Wojewodztwo Śląskie,Powiat częstochowski,G.Dąbrowa Zielona,2404022,4056,0,4056
Wojewodztwo Śląskie,Powiat częstochowski,G.Janów,2404032,5975,0,5975
Wojewodztwo Śląskie,Powiat częstochowski,G.Kamienica Polska,2404042,5577,0,5577
Wojewodztwo Śląskie,Powiat częstochowski,G.Kłomnice,2404052,13810,0,13810
Wojewodztwo Śląskie,Powiat częstochowski,M-W.Koniecpol,2404063,10173,6345,3828
Wojewodztwo Śląskie,Powiat częstochowski,G.Konopiska,2404072,10610,0,10610
Wojewodztwo Śląskie,Powiat częstochowski,G.Kruszyna,2404082,4928,0,4928
Wojewodztwo Śląskie,Powiat częstochowski,G.Lelów,2404092,5071,0,5071
Wojewodztwo Śląskie,Powiat częstochowski,G.Mstów,2404102,10568,0,10568
Wojewodztwo Śląskie,Powiat częstochowski,G.Mykanów,2404112,14557,0,14557
Wojewodztwo Śląskie,Powiat częstochowski,G.Olsztyn,2404122,7869,0,7869
Wojewodztwo Śląskie,Powiat częstochowski,G.Poczesna,2404132,12782,0,12782
Wojewodztwo Śląskie,Powiat częstochowski,G.Przyrów,2404142,3972,0,3972
Wojewodztwo Śląskie,Powiat częstochowski,G.Rędziny,2404152,10013,0,10013
Wojewodztwo Śląskie,Powiat częstochowski,G.Starcza,2404162,2791,0,2791
Wojewodztwo Śląskie,Powiat gliwicki,M.Knurów,2405011,39595,39595,0
Wojewodztwo Śląskie,Powiat gliwicki,M.Pyskowice,2405021,18770,18770,0
Wojewodztwo Śląskie,Powiat gliwicki,G.Gierałtowice,2405032,11074,0,11074
Wojewodztwo Śląskie,Powiat gliwicki,G.Pilchowice,2405042,11003,0,11003
Wojewodztwo Śląskie,Powiat gliwicki,G.Rudziniec,2405052,10581,0,10581
Wojewodztwo Śląskie,Powiat gliwicki,M-W.Sośnicowice,2405063,8533,1837,6696
Wojewodztwo Śląskie,Powiat gliwicki,M-W.Toszek,2405073,9541,3688,5853
Wojewodztwo Śląskie,Powiat gliwicki,G.Wielowieś,2405082,5933,0,5933
Wojewodztwo Śląskie,Powiat kłobucki,M-W.Kłobuck,2406013,20681,13250,7431
Wojewodztwo Śląskie,Powiat kłobucki,M-W.Krzepice,2406023,9397,4513,4884
Wojewodztwo Śląskie,Powiat kłobucki,G.Lipie,2406032,6474,0,6474
Wojewodztwo Śląskie,Powiat kłobucki,G.Miedźno,2406042,7593,0,7593
Wojewodztwo Śląskie,Powiat kłobucki,G.Opatów,2406052,6887,0,6887
Wojewodztwo Śląskie,Powiat kłobucki,G.Panki,2406062,5112,0,5112
Wojewodztwo Śląskie,Powiat kłobucki,G.Popów,2406072,6060,0,6060
Wojewodztwo Śląskie,Powiat kłobucki,G.Przystajń,2406082,6002,0,6002
Wojewodztwo Śląskie,Powiat kłobucki,G.Wręczyca Wielka,2406092,17508,0,17508
Wojewodztwo Śląskie,Powiat lubliniecki,M.Lubliniec,2407011,24394,24394,0
Wojewodztwo Śląskie,Powiat lubliniecki,G.Boronów,2407022,3334,0,3334
Wojewodztwo Śląskie,Powiat lubliniecki,G.Ciasna,2407032,7821,0,7821
Wojewodztwo Śląskie,Powiat lubliniecki,G.Herby,2407042,6973,0,6973
Wojewodztwo Śląskie,Powiat lubliniecki,G.Kochanowice,2407052,6752,0,6752
Wojewodztwo Śląskie,Powiat lubliniecki,G.Koszęcin,2407062,11745,0,11745
Wojewodztwo Śląskie,Powiat lubliniecki,G.Pawonków,2407072,6544,0,6544
Wojewodztwo Śląskie,Powiat lubliniecki,M-W.Woźniki,2407083,9652,4461,5191
Wojewodztwo Śląskie,Powiat mikołowski,M.Łaziska Górne,2408011,22279,22279,0
Wojewodztwo Śląskie,Powiat mikołowski,M.Mikołów,2408021,39505,39505,0
Wojewodztwo Śląskie,Powiat mikołowski,M.Orzesze,2408031,19539,19539,0
Wojewodztwo Śląskie,Powiat mikołowski,G.Ornontowice,2408042,5733,0,5733
Wojewodztwo Śląskie,Powiat mikołowski,G.Wyry,2408052,7149,0,7149
Wojewodztwo Śląskie,Powiat myszkowski,M.Myszków,2409011,32817,32817,0
Wojewodztwo Śląskie,Powiat myszkowski,M-W.Koziegłowy,2409023,14353,2499,11854
Wojewodztwo Śląskie,Powiat myszkowski,G.Niegowa,2409032,5747,0,5747
Wojewodztwo Śląskie,Powiat myszkowski,G.Poraj,2409042,10866,0,10866
Wojewodztwo Śląskie,Powiat myszkowski,M-W.Żarki,2409053,8301,4483,3818
Wojewodztwo Śląskie,Powiat pszczyński,G.Goczałkowice-Zdrój,2410012,6566,0,6566
Wojewodztwo Śląskie,Powiat pszczyński,G.Kobiór,2410022,4884,0,4884
Wojewodztwo Śląskie,Powiat pszczyński,G.Miedźna,2410032,16053,0,16053
Wojewodztwo Śląskie,Powiat pszczyński,G.Pawłowice,2410042,17918,0,17918
Wojewodztwo Śląskie,Powiat pszczyński,M-W.Pszczyna,2410053,50875,26066,24809
Wojewodztwo Śląskie,Powiat pszczyński,G.Suszec,2410062,11519,0,11519
Wojewodztwo Śląskie,Powiat raciborski,M.Racibórz,2411011,56289,56289,0
Wojewodztwo Śląskie,Powiat raciborski,G.Kornowac,2411022,4940,0,4940
Wojewodztwo Śląskie,Powiat raciborski,M-W.Krzanowice,2411033,5944,2254,3690
Wojewodztwo Śląskie,Powiat raciborski,G.Krzyżanowice,2411042,11433,0,11433
Wojewodztwo Śląskie,Powiat raciborski,M-W.Kuźnia Raciborska,2411053,12081,5587,6494
Wojewodztwo Śląskie,Powiat raciborski,G.Nędza,2411062,7231,0,7231
Wojewodztwo Śląskie,Powiat raciborski,G.Pietrowice Wielkie,2411072,7022,0,7022
Wojewodztwo Śląskie,Powiat raciborski,G.Rudnik,2411082,5159,0,5159
Wojewodztwo Śląskie,Powiat rybnicki,M-W.Czerwionka-Leszczyny,2412013,41929,28626,13303
Wojewodztwo Śląskie,Powiat rybnicki,G.Gaszowice,2412022,9104,0,9104
Wojewodztwo Śląskie,Powiat rybnicki,G.Jejkowice,2412032,3936,0,3936
Wojewodztwo Śląskie,Powiat rybnicki,G.Lyski,2412042,9456,0,9456
Wojewodztwo Śląskie,Powiat rybnicki,G.Świerklany,2412052,11669,0,11669
Wojewodztwo Śląskie,Powiat tarnogórski,M.Kalety,2413011,8676,8676,0
Wojewodztwo Śląskie,Powiat tarnogórski,M.Miasteczko Śląskie,2413021,7524,7524,0
Wojewodztwo Śląskie,Powiat tarnogórski,M.Radzionków,2413031,17203,17203,0
Wojewodztwo Śląskie,Powiat tarnogórski,M.Tarnowskie Góry,2413041,60847,60847,0
Wojewodztwo Śląskie,Powiat tarnogórski,G.Krupski Młyn,2413052,3369,0,3369
Wojewodztwo Śląskie,Powiat tarnogórski,G.Ożarowice,2413062,5532,0,5532
Wojewodztwo Śląskie,Powiat tarnogórski,G.Świerklaniec,2413072,11408,0,11408
Wojewodztwo Śląskie,Powiat tarnogórski,G.Tworóg,2413082,8046,0,8046
Wojewodztwo Śląskie,Powiat tarnogórski,G.Zbrosławice,2413092,15654,0,15654
Wojewodztwo Śląskie,Powiat bieruńsko-lędziński,M.Bieruń,2414011,19876,19876,0
Wojewodztwo Śląskie,Powiat bieruńsko-lędziński,M.Imielin,2414021,8322,8322,0
Wojewodztwo Śląskie,Powiat bieruńsko-lędziński,M.Lędziny,2414031,16426,16426,0
Wojewodztwo Śląskie,Powiat bieruńsko-lędziński,G.Bojszowy,2414042,7048,0,7048
Wojewodztwo Śląskie,Powiat bieruńsko-lędziński,G.Chełm Śląski,2414052,6023,0,6023
Wojewodztwo Śląskie,Powiat wodzisławski,M.Pszów,2415011,14418,14418,0
Wojewodztwo Śląskie,Powiat wodzisławski,M.Radlin,2415021,18105,18105,0
Wojewodztwo Śląskie,Powiat wodzisławski,M.Rydułtowy,2415031,22070,22070,0
Wojewodztwo Śląskie,Powiat wodzisławski,M.Wodzisław Śląski,2415041,49346,49346,0
Wojewodztwo Śląskie,Powiat wodzisławski,G.Godów,2415052,13073,0,13073
Wojewodztwo Śląskie,Powiat wodzisławski,G.Gorzyce,2415062,20428,0,20428
Wojewodztwo Śląskie,Powiat wodzisławski,G.Lubomia,2415072,8086,0,8086
Wojewodztwo Śląskie,Powiat wodzisławski,G.Marklowice,2415082,5365,0,5365
Wojewodztwo Śląskie,Powiat wodzisławski,G.Mszana,2415092,7302,0,7302
Wojewodztwo Śląskie,Powiat zawierciański,M.Poręba,2416011,8861,8861,0
Wojewodztwo Śląskie,Powiat zawierciański,M.Zawiercie,2416021,52091,52091,0
Wojewodztwo Śląskie,Powiat zawierciański,G.Irządze,2416032,2811,0,2811
Wojewodztwo Śląskie,Powiat zawierciański,G.Kroczyce,2416042,6315,0,6315
Wojewodztwo Śląskie,Powiat zawierciański,M-W.Łazy,2416053,16207,7215,8992
Wojewodztwo Śląskie,Powiat zawierciański,M-W.Ogrodzieniec,2416063,9453,4449,5004
Wojewodztwo Śląskie,Powiat zawierciański,M-W.Pilica,2416073,8992,1947,7045
Wojewodztwo Śląskie,Powiat zawierciański,M-W.Szczekociny,2416083,8192,3795,4397
Wojewodztwo Śląskie,Powiat zawierciański,G.Włodowice,2416092,5271,0,5271
Wojewodztwo Śląskie,Powiat zawierciański,G.Żarnowiec,2416102,4828,0,4828
Wojewodztwo Śląskie,Powiat żywiecki,M.Żywiec,2417011,32448,32448,0
Wojewodztwo Śląskie,Powiat żywiecki,G.Czernichów,2417022,6695,0,6695
Wojewodztwo Śląskie,Powiat żywiecki,G.Gilowice,2417032,5977,0,5977
Wojewodztwo Śląskie,Powiat żywiecki,G.Jeleśnia,2417042,13587,0,13587
Wojewodztwo Śląskie,Powiat żywiecki,G.Koszarawa,2417052,2468,0,2468
Wojewodztwo Śląskie,Powiat żywiecki,G.Lipowa,2417062,10163,0,10163
Wojewodztwo Śląskie,Powiat żywiecki,G.Łękawica,2417072,4426,0,4426
Wojewodztwo Śląskie,Powiat żywiecki,G.Łodygowice,2417082,13665,0,13665
Wojewodztwo Śląskie,Powiat żywiecki,G.Milówka,2417092,10108,0,10108
Wojewodztwo Śląskie,Powiat żywiecki,G.Radziechowy-Wieprz,2417102,12886,0,12886
Wojewodztwo Śląskie,Powiat żywiecki,G.Rajcza,2417112,9232,0,9232
Wojewodztwo Śląskie,Powiat żywiecki,G.Ślemień,2417122,3463,0,3463
Wojewodztwo Śląskie,Powiat żywiecki,G.Świnna,2417132,8039,0,8039
Wojewodztwo Śląskie,Powiat żywiecki,G.Ujsoły,2417142,4733,0,4733
Wojewodztwo Śląskie,Powiat żywiecki,G.Węgierska Górka,2417152,15042,0,15042
Wojewodztwo Śląskie,Powiat żywiecki,m. Bielsko-Biała,2461,174534,174534,0
Wojewodztwo Śląskie,Powiat żywiecki,m. Bytom,2462,176902,176902,0
Wojewodztwo Śląskie,Powiat żywiecki,m. Chorzów,2463,111692,111692,0
Wojewodztwo Śląskie,Powiat żywiecki,m. Częstochowa,2464,236796,236796,0
Wojewodztwo Śląskie,Powiat żywiecki,m. Dąbrowa Górnicza,2465,125905,125905,0
Wojewodztwo Śląskie,Powiat żywiecki,m. Gliwice,2466,187474,187474,0
Wojewodztwo Śląskie,Powiat żywiecki,m. Jastrzębie-Zdrój,2467,92465,92465,0
Wojewodztwo Śląskie,Powiat żywiecki,m. Jaworzno,2468,94732,94732,0
Wojewodztwo Śląskie,Powiat żywiecki,m. Katowice,2469,310764,310764,0
Wojewodztwo Śląskie,Powiat żywiecki,m. Mysłowice,2470,75446,75446,0
Wojewodztwo Śląskie,Powiat żywiecki,m. Piekary Śląskie,2471,57917,57917,0
Wojewodztwo Śląskie,Powiat żywiecki,m. Ruda Śląska,2472,142510,142510,0
Wojewodztwo Śląskie,Powiat żywiecki,m. Rybnik,2473,140924,140924,0
Wojewodztwo Śląskie,Powiat żywiecki,m. Siemianowice Śląskie,2474,70170,70170,0
Wojewodztwo Śląskie,Powiat żywiecki,m. Sosnowiec,2475,216420,216420,0
Wojewodztwo Śląskie,Powiat żywiecki,m. Świętochłowice,2476,53150,53150,0
Wojewodztwo Śląskie,Powiat żywiecki,m. Tychy,2477,129378,129378,0
Wojewodztwo Śląskie,Powiat żywiecki,m. Zabrze,2478,181128,181128,0
Wojewodztwo Śląskie,Powiat żywiecki,m. Żory,2479,62094,62094,0
Wojewodztwo Świętokrzyskie,Powiat buski,M-W.Busko-Zdrój,2601013,32995,17120,15875
Wojewodztwo Świętokrzyskie,Powiat buski,G.Gnojno,2601022,4624,0,4624
Wojewodztwo Świętokrzyskie,Powiat buski,G.Nowy Korczyn,2601032,6389,0,6389
Wojewodztwo Świętokrzyskie,Powiat buski,G.Pacanów,2601042,7829,0,7829
Wojewodztwo Świętokrzyskie,Powiat buski,G.Solec-Zdrój,2601052,5120,0,5120
Wojewodztwo Świętokrzyskie,Powiat buski,G.Stopnica,2601062,7936,0,7936
Wojewodztwo Świętokrzyskie,Powiat buski,G.Tuczępy,2601072,3840,0,3840
Wojewodztwo Świętokrzyskie,Powiat buski,G.Wiślica,2601082,5779,0,5779
Wojewodztwo Świętokrzyskie,Powiat jędrzejowski,G.Imielno,2602012,4485,0,4485
Wojewodztwo Świętokrzyskie,Powiat jędrzejowski,M-W.Jędrzejów,2602023,29120,16166,12954
Wojewodztwo Świętokrzyskie,Powiat jędrzejowski,M-W.Małogoszcz,2602033,11807,3990,7817
Wojewodztwo Świętokrzyskie,Powiat jędrzejowski,G.Nagłowice,2602042,5220,0,5220
Wojewodztwo Świętokrzyskie,Powiat jędrzejowski,G.Oksa,2602052,4794,0,4794
Wojewodztwo Świętokrzyskie,Powiat jędrzejowski,M-W.Sędziszów,2602063,12997,6723,6274
Wojewodztwo Świętokrzyskie,Powiat jędrzejowski,G.Słupia Jędrzejowska,2602072,4408,0,4408
Wojewodztwo Świętokrzyskie,Powiat jędrzejowski,G.Sobków,2602082,8442,0,8442
Wojewodztwo Świętokrzyskie,Powiat jędrzejowski,G.Wodzisław,2602092,7478,0,7478
Wojewodztwo Świętokrzyskie,Powiat kazimierski,G.Bejsce,2603012,4324,0,4324
Wojewodztwo Świętokrzyskie,Powiat kazimierski,G.Czarnocin,2603022,4059,0,4059
Wojewodztwo Świętokrzyskie,Powiat kazimierski,M-W.Kazimierza Wielka,2603033,16960,5938,11022
Wojewodztwo Świętokrzyskie,Powiat kazimierski,G.Opatowiec,2603042,3517,0,3517
Wojewodztwo Świętokrzyskie,Powiat kazimierski,M-W.Skalbmierz,2603053,6879,1361,5518
Wojewodztwo Świętokrzyskie,Powiat kielecki,G.Bieliny,2604012,10110,0,10110
Wojewodztwo Świętokrzyskie,Powiat kielecki,M-W.Bodzentyn,2604023,11799,2316,9483
Wojewodztwo Świętokrzyskie,Powiat kielecki,M-W.Chęciny,2604033,15085,4475,10610
Wojewodztwo Świętokrzyskie,Powiat kielecki,M-W.Chmielnik,2604043,11550,3983,7567
Wojewodztwo Świętokrzyskie,Powiat kielecki,M-W.Daleszyce,2604053,15459,2965,12494
Wojewodztwo Świętokrzyskie,Powiat kielecki,G.Górno,2604062,13527,0,13527
Wojewodztwo Świętokrzyskie,Powiat kielecki,G.Łagów,2604072,6999,0,6999
Wojewodztwo Świętokrzyskie,Powiat kielecki,G.Łopuszno,2604082,9056,0,9056
Wojewodztwo Świętokrzyskie,Powiat kielecki,G.Masłów,2604092,10328,0,10328
Wojewodztwo Świętokrzyskie,Powiat kielecki,G.Miedziana Góra,2604102,10706,0,10706
Wojewodztwo Świętokrzyskie,Powiat kielecki,G.Mniów,2604112,9391,0,9391
Wojewodztwo Świętokrzyskie,Powiat kielecki,G.Morawica,2604122,14702,0,14702
Wojewodztwo Świętokrzyskie,Powiat kielecki,G.Nowa Słupia,2604132,9784,0,9784
Wojewodztwo Świętokrzyskie,Powiat kielecki,G.Piekoszów,2604142,15861,0,15861
Wojewodztwo Świętokrzyskie,Powiat kielecki,G.Pierzchnica,2604152,4805,0,4805
Wojewodztwo Świętokrzyskie,Powiat kielecki,G.Raków,2604162,5848,0,5848
Wojewodztwo Świętokrzyskie,Powiat kielecki,G.Sitkówka-Nowiny,2604172,7439,0,7439
Wojewodztwo Świętokrzyskie,Powiat kielecki,G.Strawczyn,2604182,10181,0,10181
Wojewodztwo Świętokrzyskie,Powiat kielecki,G.Zagnańsk,2604192,12870,0,12870
Wojewodztwo Świętokrzyskie,Powiat konecki,G.Fałków,2605012,4766,0,4766
Wojewodztwo Świętokrzyskie,Powiat konecki,G.Gowarczów,2605022,4736,0,4736
Wojewodztwo Świętokrzyskie,Powiat konecki,M-W.Końskie,2605033,37018,20920,16098
Wojewodztwo Świętokrzyskie,Powiat konecki,G.Radoszyce,2605042,9257,0,9257
Wojewodztwo Świętokrzyskie,Powiat konecki,G.Ruda Maleniecka,2605052,3294,0,3294
Wojewodztwo Świętokrzyskie,Powiat konecki,G.Słupia Konecka,2605062,3519,0,3519
Wojewodztwo Świętokrzyskie,Powiat konecki,G.Smyków,2605072,3767,0,3767
Wojewodztwo Świętokrzyskie,Powiat konecki,M-W.Stąporków,2605083,18171,6142,12029
Wojewodztwo Świętokrzyskie,Powiat opatowski,G.Baćkowice,2606012,5119,0,5119
Wojewodztwo Świętokrzyskie,Powiat opatowski,G.Iwaniska,2606022,6987,0,6987
Wojewodztwo Świętokrzyskie,Powiat opatowski,G.Lipnik,2606032,5676,0,5676
Wojewodztwo Świętokrzyskie,Powiat opatowski,M-W.Opatów,2606043,12450,6864,5586
Wojewodztwo Świętokrzyskie,Powiat opatowski,M-W.Ożarów,2606053,11300,4849,6451
Wojewodztwo Świętokrzyskie,Powiat opatowski,G.Sadowie,2606062,4198,0,4198
Wojewodztwo Świętokrzyskie,Powiat opatowski,G.Tarłów,2606072,5581,0,5581
Wojewodztwo Świętokrzyskie,Powiat opatowski,G.Wojciechowice,2606082,4352,0,4352
Wojewodztwo Świętokrzyskie,Powiat ostrowiecki,M.Ostrowiec Świętokrzyski,2607011,73681,73681,0
Wojewodztwo Świętokrzyskie,Powiat ostrowiecki,G.Bałtów,2607022,3820,0,3820
Wojewodztwo Świętokrzyskie,Powiat ostrowiecki,G.Bodzechów,2607032,13725,0,13725
Wojewodztwo Świętokrzyskie,Powiat ostrowiecki,M-W.Ćmielów,2607043,7812,3238,4574
Wojewodztwo Świętokrzyskie,Powiat ostrowiecki,M-W.Kunów,2607053,10117,3170,6947
Wojewodztwo Świętokrzyskie,Powiat ostrowiecki,G.Waśniów,2607062,7126,0,7126
Wojewodztwo Świętokrzyskie,Powiat pińczowski,M-W.Działoszyce,2608013,5357,1034,4323
Wojewodztwo Świętokrzyskie,Powiat pińczowski,G.Kije,2608022,4526,0,4526
Wojewodztwo Świętokrzyskie,Powiat pińczowski,G.Michałów,2608032,4830,0,4830
Wojewodztwo Świętokrzyskie,Powiat pińczowski,M-W.Pińczów,2608043,21813,11612,10201
Wojewodztwo Świętokrzyskie,Powiat pińczowski,G.Złota,2608052,4785,0,4785
Wojewodztwo Świętokrzyskie,Powiat sandomierski,M.Sandomierz,2609011,24894,24894,0
Wojewodztwo Świętokrzyskie,Powiat sandomierski,G.Dwikozy,2609022,9129,0,9129
Wojewodztwo Świętokrzyskie,Powiat sandomierski,G.Klimontów,2609032,8583,0,8583
Wojewodztwo Świętokrzyskie,Powiat sandomierski,M-W.Koprzywnica,2609043,7016,2621,4395
Wojewodztwo Świętokrzyskie,Powiat sandomierski,G.Łoniów,2609052,7507,0,7507
Wojewodztwo Świętokrzyskie,Powiat sandomierski,G.Obrazów,2609062,6694,0,6694
Wojewodztwo Świętokrzyskie,Powiat sandomierski,G.Samborzec,2609072,8812,0,8812
Wojewodztwo Świętokrzyskie,Powiat sandomierski,G.Wilczyce,2609082,3851,0,3851
Wojewodztwo Świętokrzyskie,Powiat sandomierski,M-W.Zawichost,2609093,4706,1881,2825
Wojewodztwo Świętokrzyskie,Powiat skarżyski,M.Skarżysko-Kamienna,2610011,48580,48580,0
Wojewodztwo Świętokrzyskie,Powiat skarżyski,G.Bliżyn,2610022,8521,0,8521
Wojewodztwo Świętokrzyskie,Powiat skarżyski,G.Łączna,2610032,5337,0,5337
Wojewodztwo Świętokrzyskie,Powiat skarżyski,G.Skarżysko Kościelne,2610042,6291,0,6291
Wojewodztwo Świętokrzyskie,Powiat skarżyski,M-W.Suchedniów,2610053,10741,8849,1892
Wojewodztwo Świętokrzyskie,Powiat starachowicki,M.Starachowice,2611011,52359,52359,0
Wojewodztwo Świętokrzyskie,Powiat starachowicki,G.Brody,2611022,11165,0,11165
Wojewodztwo Świętokrzyskie,Powiat starachowicki,G.Mirzec,2611032,8445,0,8445
Wojewodztwo Świętokrzyskie,Powiat starachowicki,G.Pawłów,2611042,15320,0,15320
Wojewodztwo Świętokrzyskie,Powiat starachowicki,M-W.Wąchock,2611053,7167,2884,4283
Wojewodztwo Świętokrzyskie,Powiat staszowski,G.Bogoria,2612012,7975,0,7975
Wojewodztwo Świętokrzyskie,Powiat staszowski,G.Łubnice,2612022,4358,0,4358
Wojewodztwo Świętokrzyskie,Powiat staszowski,G.Oleśnica,2612032,3970,0,3970
Wojewodztwo Świętokrzyskie,Powiat staszowski,M-W.Osiek,2612043,7872,2004,5868
Wojewodztwo Świętokrzyskie,Powiat staszowski,M-W.Połaniec,2612053,12084,8448,3636
Wojewodztwo Świętokrzyskie,Powiat staszowski,G.Rytwiany,2612062,6440,0,6440
Wojewodztwo Świętokrzyskie,Powiat staszowski,M-W.Staszów,2612073,26749,15760,10989
Wojewodztwo Świętokrzyskie,Powiat staszowski,G.Szydłów,2612082,4841,0,4841
Wojewodztwo Świętokrzyskie,Powiat włoszczowski,G.Kluczewsko,2613012,5280,0,5280
Wojewodztwo Świętokrzyskie,Powiat włoszczowski,G.Krasocin,2613022,10837,0,10837
Wojewodztwo Świętokrzyskie,Powiat włoszczowski,G.Moskorzew,2613032,2803,0,2803
Wojewodztwo Świętokrzyskie,Powiat włoszczowski,G.Radków,2613042,2575,0,2575
Wojewodztwo Świętokrzyskie,Powiat włoszczowski,G.Secemin,2613052,4997,0,4997
Wojewodztwo Świętokrzyskie,Powiat włoszczowski,M-W.Włoszczowa,2613063,20347,10823,9524
Wojewodztwo Świętokrzyskie,Powiat włoszczowski,m. Kielce,2661,202196,202196,0
Wojewodztwo Warmińsko-mazurskie,Powiat bartoszycki,M.Bartoszyce,2801011,25022,25022,0
Wojewodztwo Warmińsko-mazurskie,Powiat bartoszycki,M.Górowo Iławeckie,2801021,4424,4424,0
Wojewodztwo Warmińsko-mazurskie,Powiat bartoszycki,G.Bartoszyce,2801032,11045,0,11045
Wojewodztwo Warmińsko-mazurskie,Powiat bartoszycki,M-W.Bisztynek,2801043,6829,2554,4275
Wojewodztwo Warmińsko-mazurskie,Powiat bartoszycki,G.Górowo Iławeckie,2801052,7189,0,7189
Wojewodztwo Warmińsko-mazurskie,Powiat bartoszycki,M-W.Sępopol,2801063,6779,2127,4652
Wojewodztwo Warmińsko-mazurskie,Powiat braniewski,M.Braniewo,2802011,17778,17778,0
Wojewodztwo Warmińsko-mazurskie,Powiat braniewski,G.Braniewo,2802022,6379,0,6379
Wojewodztwo Warmińsko-mazurskie,Powiat braniewski,M-W.Frombork,2802033,3758,2476,1282
Wojewodztwo Warmińsko-mazurskie,Powiat braniewski,G.Lelkowo,2802042,3086,0,3086
Wojewodztwo Warmińsko-mazurskie,Powiat braniewski,M-W.Pieniężno,2802053,6746,2988,3758
Wojewodztwo Warmińsko-mazurskie,Powiat braniewski,G.Płoskinia,2802062,2653,0,2653
Wojewodztwo Warmińsko-mazurskie,Powiat braniewski,G.Wilczęta,2802072,3144,0,3144
Wojewodztwo Warmińsko-mazurskie,Powiat działdowski,M.Działdowo,2803011,21619,21619,0
Wojewodztwo Warmińsko-mazurskie,Powiat działdowski,G.Działdowo,2803022,9777,0,9777
Wojewodztwo Warmińsko-mazurskie,Powiat działdowski,G.Iłowo-Osada,2803032,7368,0,7368
Wojewodztwo Warmińsko-mazurskie,Powiat działdowski,M-W.Lidzbark,2803043,14739,8275,6464
Wojewodztwo Warmińsko-mazurskie,Powiat działdowski,G.Płośnica,2803052,5950,0,5950
Wojewodztwo Warmińsko-mazurskie,Powiat działdowski,G.Rybno,2803062,7372,0,7372
Wojewodztwo Warmińsko-mazurskie,Powiat elbląski,G.Elbląg,2804012,7150,0,7150
Wojewodztwo Warmińsko-mazurskie,Powiat elbląski,G.Godkowo,2804022,3328,0,3328
Wojewodztwo Warmińsko-mazurskie,Powiat elbląski,G.Gronowo Elbląskie,2804032,5173,0,5173
Wojewodztwo Warmińsko-mazurskie,Powiat elbląski,G.Markusy,2804042,4219,0,4219
Wojewodztwo Warmińsko-mazurskie,Powiat elbląski,G.Milejewo,2804052,3200,0,3200
Wojewodztwo Warmińsko-mazurskie,Powiat elbląski,M-W.Młynary,2804063,4634,1870,2764
Wojewodztwo Warmińsko-mazurskie,Powiat elbląski,M-W.Pasłęk,2804073,19672,12396,7276
Wojewodztwo Warmińsko-mazurskie,Powiat elbląski,G.Rychliki,2804082,4112,0,4112
Wojewodztwo Warmińsko-mazurskie,Powiat elbląski,M-W.Tolkmicko,2804093,6838,2819,4019
Wojewodztwo Warmińsko-mazurskie,Powiat ełcki,M.Ełk,2805011,59044,59044,0
Wojewodztwo Warmińsko-mazurskie,Powiat ełcki,G.Ełk,2805022,10930,0,10930
Wojewodztwo Warmińsko-mazurskie,Powiat ełcki,G.Kalinowo,2805032,7052,0,7052
Wojewodztwo Warmińsko-mazurskie,Powiat ełcki,G.Prostki,2805042,7552,0,7552
Wojewodztwo Warmińsko-mazurskie,Powiat ełcki,G.Stare Juchy,2805052,3974,0,3974
Wojewodztwo Warmińsko-mazurskie,Powiat giżycki,M.Giżycko,2806011,30178,30178,0
Wojewodztwo Warmińsko-mazurskie,Powiat giżycki,G.Giżycko,2806042,8028,0,8028
Wojewodztwo Warmińsko-mazurskie,Powiat giżycki,G.Kruklanki,2806052,3139,0,3139
Wojewodztwo Warmińsko-mazurskie,Powiat giżycki,G.Miłki,2806062,3919,0,3919
Wojewodztwo Warmińsko-mazurskie,Powiat giżycki,M-W.Ryn,2806083,5888,2995,2893
Wojewodztwo Warmińsko-mazurskie,Powiat giżycki,G.Wydminy,2806102,6637,0,6637
Wojewodztwo Warmińsko-mazurskie,Powiat iławski,M.Iława,2807011,33321,33321,0
Wojewodztwo Warmińsko-mazurskie,Powiat iławski,M.Lubawa,2807021,9951,9951,0
Wojewodztwo Warmińsko-mazurskie,Powiat iławski,G.Iława,2807032,12612,0,12612
Wojewodztwo Warmińsko-mazurskie,Powiat iławski,M-W.Kisielice,2807043,6217,2204,4013
Wojewodztwo Warmińsko-mazurskie,Powiat iławski,G.Lubawa,2807052,10572,0,10572
Wojewodztwo Warmińsko-mazurskie,Powiat iławski,M-W.Susz,2807063,13126,5748,7378
Wojewodztwo Warmińsko-mazurskie,Powiat iławski,M-W.Zalewo,2807073,7116,2227,4889
Wojewodztwo Warmińsko-mazurskie,Powiat kętrzyński,M.Kętrzyn,2808011,28466,28466,0
Wojewodztwo Warmińsko-mazurskie,Powiat kętrzyński,G.Barciany,2808022,6782,0,6782
Wojewodztwo Warmińsko-mazurskie,Powiat kętrzyński,G.Kętrzyn,2808032,8439,0,8439
Wojewodztwo Warmińsko-mazurskie,Powiat kętrzyński,M-W.Korsze,2808043,10613,4644,5969
Wojewodztwo Warmińsko-mazurskie,Powiat kętrzyński,M-W.Reszel,2808053,8219,4986,3233
Wojewodztwo Warmińsko-mazurskie,Powiat kętrzyński,G.Srokowo,2808062,4118,0,4118
Wojewodztwo Warmińsko-mazurskie,Powiat lidzbarski,M.Lidzbark Warmiński,2809011,16639,16639,0
Wojewodztwo Warmińsko-mazurskie,Powiat lidzbarski,G.Kiwity,2809022,3429,0,3429
Wojewodztwo Warmińsko-mazurskie,Powiat lidzbarski,G.Lidzbark Warmiński,2809032,6803,0,6803
Wojewodztwo Warmińsko-mazurskie,Powiat lidzbarski,G.Lubomino,2809042,3652,0,3652
Wojewodztwo Warmińsko-mazurskie,Powiat lidzbarski,M-W.Orneta,2809053,12659,9243,3416
Wojewodztwo Warmińsko-mazurskie,Powiat mrągowski,M.Mrągowo,2810011,22324,22324,0
Wojewodztwo Warmińsko-mazurskie,Powiat mrągowski,M-W.Mikołajki,2810023,8566,3968,4598
Wojewodztwo Warmińsko-mazurskie,Powiat mrągowski,G.Mrągowo,2810032,7865,0,7865
Wojewodztwo Warmińsko-mazurskie,Powiat mrągowski,G.Piecki,2810042,7928,0,7928
Wojewodztwo Warmińsko-mazurskie,Powiat mrągowski,G.Sorkwity,2810052,4746,0,4746
Wojewodztwo Warmińsko-mazurskie,Powiat nidzicki,G.Janowiec Kościelny,2811012,3421,0,3421
Wojewodztwo Warmińsko-mazurskie,Powiat nidzicki,G.Janowo,2811022,2897,0,2897
Wojewodztwo Warmińsko-mazurskie,Powiat nidzicki,G.Kozłowo,2811032,6334,0,6334
Wojewodztwo Warmińsko-mazurskie,Powiat nidzicki,M-W.Nidzica,2811043,21712,14544,7168
Wojewodztwo Warmińsko-mazurskie,Powiat nowomiejski,M.Nowe Miasto Lubawskie,2812011,11166,11166,0
Wojewodztwo Warmińsko-mazurskie,Powiat nowomiejski,G.Biskupiec,2812022,9647,0,9647
Wojewodztwo Warmińsko-mazurskie,Powiat nowomiejski,G.Grodziczno,2812032,6402,0,6402
Wojewodztwo Warmińsko-mazurskie,Powiat nowomiejski,G.Kurzętnik,2812042,9013,0,9013
Wojewodztwo Warmińsko-mazurskie,Powiat nowomiejski,G.Nowe Miasto Lubawskie,2812052,8044,0,8044
Wojewodztwo Warmińsko-mazurskie,Powiat olecki,G.Kowale Oleckie,2813032,5436,0,5436
Wojewodztwo Warmińsko-mazurskie,Powiat olecki,M-W.Olecko,2813043,22163,16557,5606
Wojewodztwo Warmińsko-mazurskie,Powiat olecki,G.Świętajno,2813052,3994,0,3994
Wojewodztwo Warmińsko-mazurskie,Powiat olecki,G.Wieliczki,2813062,3474,0,3474
Wojewodztwo Warmińsko-mazurskie,Powiat olsztyński,M-W.Barczewo,2814013,17083,7349,9734
Wojewodztwo Warmińsko-mazurskie,Powiat olsztyński,M-W.Biskupiec,2814023,19309,10657,8652
Wojewodztwo Warmińsko-mazurskie,Powiat olsztyński,M-W.Dobre Miasto,2814033,16199,10730,5469
Wojewodztwo Warmińsko-mazurskie,Powiat olsztyński,G.Dywity,2814042,10453,0,10453
Wojewodztwo Warmińsko-mazurskie,Powiat olsztyński,G.Gietrzwałd,2814052,6019,0,6019
Wojewodztwo Warmińsko-mazurskie,Powiat olsztyński,M-W.Jeziorany,2814063,8075,3351,4724
Wojewodztwo Warmińsko-mazurskie,Powiat olsztyński,G.Jonkowo,2814072,6634,0,6634
Wojewodztwo Warmińsko-mazurskie,Powiat olsztyński,G.Kolno,2814082,3422,0,3422
Wojewodztwo Warmińsko-mazurskie,Powiat olsztyński,M-W.Olsztynek,2814093,13947,7725,6222
Wojewodztwo Warmińsko-mazurskie,Powiat olsztyński,G.Purda,2814102,8157,0,8157
Wojewodztwo Warmińsko-mazurskie,Powiat olsztyński,G.Stawiguda,2814112,6440,0,6440
Wojewodztwo Warmińsko-mazurskie,Powiat olsztyński,G.Świątki,2814122,4224,0,4224
Wojewodztwo Warmińsko-mazurskie,Powiat ostródzki,M.Ostróda,2815011,34060,34060,0
Wojewodztwo Warmińsko-mazurskie,Powiat ostródzki,G.Dąbrówno,2815022,4523,0,4523
Wojewodztwo Warmińsko-mazurskie,Powiat ostródzki,G.Grunwald,2815032,5837,0,5837
Wojewodztwo Warmińsko-mazurskie,Powiat ostródzki,G.Łukta,2815042,4496,0,4496
Wojewodztwo Warmińsko-mazurskie,Powiat ostródzki,G.Małdyty,2815052,6522,0,6522
Wojewodztwo Warmińsko-mazurskie,Powiat ostródzki,M-W.Miłakowo,2815063,5814,2734,3080
Wojewodztwo Warmińsko-mazurskie,Powiat ostródzki,M-W.Miłomłyn,2815073,5102,2416,2686
Wojewodztwo Warmińsko-mazurskie,Powiat ostródzki,M-W.Morąg,2815083,25245,14586,10659
Wojewodztwo Warmińsko-mazurskie,Powiat ostródzki,G.Ostróda,2815092,15834,0,15834
Wojewodztwo Warmińsko-mazurskie,Powiat piski,M-W.Biała Piska,2816013,12399,4158,8241
Wojewodztwo Warmińsko-mazurskie,Powiat piski,M-W.Orzysz,2816023,9600,5905,3695
Wojewodztwo Warmińsko-mazurskie,Powiat piski,M-W.Pisz,2816033,27957,19675,8282
Wojewodztwo Warmińsko-mazurskie,Powiat piski,M-W.Ruciane-Nida,2816043,8548,4821,3727
Wojewodztwo Warmińsko-mazurskie,Powiat szczycieński,M.Szczytno,2817011,25254,25254,0
Wojewodztwo Warmińsko-mazurskie,Powiat szczycieński,G.Dźwierzuty,2817022,6818,0,6818
Wojewodztwo Warmińsko-mazurskie,Powiat szczycieński,G.Jedwabno,2817032,3700,0,3700
Wojewodztwo Warmińsko-mazurskie,Powiat szczycieński,M-W.Pasym,2817043,5391,2532,2859
Wojewodztwo Warmińsko-mazurskie,Powiat szczycieński,G.Rozogi,2817052,5816,0,5816
Wojewodztwo Warmińsko-mazurskie,Powiat szczycieński,G.Szczytno,2817062,11706,0,11706
Wojewodztwo Warmińsko-mazurskie,Powiat szczycieński,G.Świętajno,2817072,6116,0,6116
Wojewodztwo Warmińsko-mazurskie,Powiat szczycieński,G.Wielbark,2817082,6564,0,6564
Wojewodztwo Warmińsko-mazurskie,Powiat gołdapski,G.Banie Mazurskie,2818012,3967,0,3967
Wojewodztwo Warmińsko-mazurskie,Powiat gołdapski,G.Dubeninki,2818022,3132,0,3132
Wojewodztwo Warmińsko-mazurskie,Powiat gołdapski,M-W.Gołdap,2818033,20466,13788,6678
Wojewodztwo Warmińsko-mazurskie,Powiat węgorzewski,G.Budry,2819012,3003,0,3003
Wojewodztwo Warmińsko-mazurskie,Powiat węgorzewski,G.Pozezdrze,2819022,3441,0,3441
Wojewodztwo Warmińsko-mazurskie,Powiat węgorzewski,M-W.Węgorzewo,2819033,17371,11749,5622
Wojewodztwo Warmińsko-mazurskie,Powiat węgorzewski,m. Elbląg,2861,124668,124668,0
Wojewodztwo Warmińsko-mazurskie,Powiat węgorzewski,m. Olsztyn,2862,174645,174645,0
Wojewodztwo Wielkopolskie,Powiat chodzieski,M.Chodzież,3001011,19715,19715,0
Wojewodztwo Wielkopolskie,Powiat chodzieski,G.Budzyń,3001022,8405,0,8405
Wojewodztwo Wielkopolskie,Powiat chodzieski,G.Chodzież,3001032,5741,0,5741
Wojewodztwo Wielkopolskie,Powiat chodzieski,M-W.Margonin,3001043,6426,3038,3388
Wojewodztwo Wielkopolskie,Powiat chodzieski,M-W.Szamocin,3001053,7550,4356,3194
Wojewodztwo Wielkopolskie,Powiat czarnkowsko-trzcianecki,M.Czarnków,3002011,11543,11543,0
Wojewodztwo Wielkopolskie,Powiat czarnkowsko-trzcianecki,G.Czarnków,3002022,11054,0,11054
Wojewodztwo Wielkopolskie,Powiat czarnkowsko-trzcianecki,G.Drawsko,3002032,6015,0,6015
Wojewodztwo Wielkopolskie,Powiat czarnkowsko-trzcianecki,M-W.Krzyż Wielkopolski,3002043,8824,6240,2584
Wojewodztwo Wielkopolskie,Powiat czarnkowsko-trzcianecki,G.Lubasz,3002052,7337,0,7337
Wojewodztwo Wielkopolskie,Powiat czarnkowsko-trzcianecki,G.Połajewo,3002062,6254,0,6254
Wojewodztwo Wielkopolskie,Powiat czarnkowsko-trzcianecki,M-W.Trzcianka,3002073,24490,17424,7066
Wojewodztwo Wielkopolskie,Powiat czarnkowsko-trzcianecki,M-W.Wieleń,3002083,12787,6042,6745
Wojewodztwo Wielkopolskie,Powiat gnieźnieński,M.Gniezno,3003011,70322,70322,0
Wojewodztwo Wielkopolskie,Powiat gnieźnieński,M-W.Czerniejewo,3003023,7172,2639,4533
Wojewodztwo Wielkopolskie,Powiat gnieźnieński,G.Gniezno,3003032,9833,0,9833
Wojewodztwo Wielkopolskie,Powiat gnieźnieński,G.Kiszkowo,3003042,5352,0,5352
Wojewodztwo Wielkopolskie,Powiat gnieźnieński,M-W.Kłecko,3003053,7580,2684,4896
Wojewodztwo Wielkopolskie,Powiat gnieźnieński,G.Łubowo,3003062,5952,0,5952
Wojewodztwo Wielkopolskie,Powiat gnieźnieński,G.Mieleszyn,3003072,4061,0,4061
Wojewodztwo Wielkopolskie,Powiat gnieźnieński,G.Niechanowo,3003082,5594,0,5594
Wojewodztwo Wielkopolskie,Powiat gnieźnieński,M-W.Trzemeszno,3003093,14366,7800,6566
Wojewodztwo Wielkopolskie,Powiat gnieźnieński,M-W.Witkowo,3003103,13721,8042,5679
Wojewodztwo Wielkopolskie,Powiat gostyński,M-W.Borek Wielkopolski,3004013,7659,2505,5154
Wojewodztwo Wielkopolskie,Powiat gostyński,M-W.Gostyń,3004023,27914,20318,7596
Wojewodztwo Wielkopolskie,Powiat gostyński,M-W.Krobia,3004033,13010,4207,8803
Wojewodztwo Wielkopolskie,Powiat gostyński,G.Pępowo,3004042,6017,0,6017
Wojewodztwo Wielkopolskie,Powiat gostyński,G.Piaski,3004052,8502,0,8502
Wojewodztwo Wielkopolskie,Powiat gostyński,M-W.Pogorzela,3004063,5162,2044,3118
Wojewodztwo Wielkopolskie,Powiat gostyński,M-W.Poniec,3004073,7975,2889,5086
Wojewodztwo Wielkopolskie,Powiat grodziski,G.Granowo,3005012,5019,0,5019
Wojewodztwo Wielkopolskie,Powiat grodziski,M-W.Grodzisk Wielkopolski,3005023,19241,14134,5107
Wojewodztwo Wielkopolskie,Powiat grodziski,G.Kamieniec,3005032,6491,0,6491
Wojewodztwo Wielkopolskie,Powiat grodziski,M-W.Rakoniewice,3005043,12833,3468,9365
Wojewodztwo Wielkopolskie,Powiat grodziski,M-W.Wielichowo,3005053,6848,1757,5091
Wojewodztwo Wielkopolskie,Powiat jarociński,G.Jaraczewo,3006012,8368,0,8368
Wojewodztwo Wielkopolskie,Powiat jarociński,M-W.Jarocin,3006023,45330,26324,19006
Wojewodztwo Wielkopolskie,Powiat jarociński,G.Kotlin,3006032,7193,0,7193
Wojewodztwo Wielkopolskie,Powiat jarociński,M-W.Żerków,3006043,10538,2142,8396
Wojewodztwo Wielkopolskie,Powiat kaliski,G.Blizanów,3007012,9626,0,9626
Wojewodztwo Wielkopolskie,Powiat kaliski,G.Brzeziny,3007022,5840,0,5840
Wojewodztwo Wielkopolskie,Powiat kaliski,G.Ceków-Kolonia,3007032,4775,0,4775
Wojewodztwo Wielkopolskie,Powiat kaliski,G.Godziesze Wielkie,3007042,8887,0,8887
Wojewodztwo Wielkopolskie,Powiat kaliski,G.Koźminek,3007052,7525,0,7525
Wojewodztwo Wielkopolskie,Powiat kaliski,G.Lisków,3007062,5412,0,5412
Wojewodztwo Wielkopolskie,Powiat kaliski,G.Mycielin,3007072,4890,0,4890
Wojewodztwo Wielkopolskie,Powiat kaliski,G.Opatówek,3007082,10690,0,10690
Wojewodztwo Wielkopolskie,Powiat kaliski,M-W.Stawiszyn,3007093,7298,1593,5705
Wojewodztwo Wielkopolskie,Powiat kaliski,G.Szczytniki,3007102,7960,0,7960
Wojewodztwo Wielkopolskie,Powiat kaliski,G.Żelazków,3007112,9217,0,9217
Wojewodztwo Wielkopolskie,Powiat kępiński,G.Baranów,3008012,7734,0,7734
Wojewodztwo Wielkopolskie,Powiat kępiński,G.Bralin,3008022,5945,0,5945
Wojewodztwo Wielkopolskie,Powiat kępiński,M-W.Kępno,3008033,24801,14760,10041
Wojewodztwo Wielkopolskie,Powiat kępiński,G.Łęka Opatowska,3008042,5325,0,5325
Wojewodztwo Wielkopolskie,Powiat kępiński,G.Perzów,3008052,3848,0,3848
Wojewodztwo Wielkopolskie,Powiat kępiński,G.Rychtal,3008062,3955,0,3955
Wojewodztwo Wielkopolskie,Powiat kępiński,G.Trzcinica,3008072,4829,0,4829
Wojewodztwo Wielkopolskie,Powiat kolski,M.Koło,3009011,23360,23360,0
Wojewodztwo Wielkopolskie,Powiat kolski,G.Babiak,3009022,8036,0,8036
Wojewodztwo Wielkopolskie,Powiat kolski,G.Chodów,3009032,3392,0,3392
Wojewodztwo Wielkopolskie,Powiat kolski,M-W.Dąbie,3009043,6601,2089,4512
Wojewodztwo Wielkopolskie,Powiat kolski,G.Grzegorzew,3009052,5678,0,5678
Wojewodztwo Wielkopolskie,Powiat kolski,M-W.Kłodawa,3009063,13448,6784,6664
Wojewodztwo Wielkopolskie,Powiat kolski,G.Koło,3009072,7437,0,7437
Wojewodztwo Wielkopolskie,Powiat kolski,G.Kościelec,3009082,6607,0,6607
Wojewodztwo Wielkopolskie,Powiat kolski,G.Olszówka,3009092,4696,0,4696
Wojewodztwo Wielkopolskie,Powiat kolski,G.Osiek Mały,3009102,5957,0,5957
Wojewodztwo Wielkopolskie,Powiat kolski,M-W.Przedecz,3009113,4337,1783,2554
Wojewodztwo Wielkopolskie,Powiat koniński,M-W.Golina,3010013,11774,4496,7278
Wojewodztwo Wielkopolskie,Powiat koniński,G.Grodziec,3010022,5267,0,5267
Wojewodztwo Wielkopolskie,Powiat koniński,G.Kazimierz Biskupi,3010032,11072,0,11072
Wojewodztwo Wielkopolskie,Powiat koniński,M-W.Kleczew,3010043,9967,4231,5736
Wojewodztwo Wielkopolskie,Powiat koniński,G.Kramsk,3010052,10586,0,10586
Wojewodztwo Wielkopolskie,Powiat koniński,G.Krzymów,3010062,7438,0,7438
Wojewodztwo Wielkopolskie,Powiat koniński,M-W.Rychwał,3010073,8363,2378,5985
Wojewodztwo Wielkopolskie,Powiat koniński,G.Rzgów,3010082,7062,0,7062
Wojewodztwo Wielkopolskie,Powiat koniński,G.Skulsk,3010092,6258,0,6258
Wojewodztwo Wielkopolskie,Powiat koniński,M-W.Sompolno,3010103,10553,3717,6836
Wojewodztwo Wielkopolskie,Powiat koniński,G.Stare Miasto,3010112,11238,0,11238
Wojewodztwo Wielkopolskie,Powiat koniński,M-W.Ślesin,3010123,13828,3137,10691
Wojewodztwo Wielkopolskie,Powiat koniński,G.Wierzbinek,3010132,7654,0,7654
Wojewodztwo Wielkopolskie,Powiat koniński,G.Wilczyn,3010142,6402,0,6402
Wojewodztwo Wielkopolskie,Powiat kościański,M.Kościan,3011011,24194,24194,0
Wojewodztwo Wielkopolskie,Powiat kościański,M-W.Czempiń,3011023,11392,5232,6160
Wojewodztwo Wielkopolskie,Powiat kościański,G.Kościan,3011032,15537,0,15537
Wojewodztwo Wielkopolskie,Powiat kościański,M-W.Krzywiń,3011043,10059,1639,8420
Wojewodztwo Wielkopolskie,Powiat kościański,M-W.Śmigiel,3011053,17624,5613,12011
Wojewodztwo Wielkopolskie,Powiat krotoszyński,M.Sulmierzyce,3012011,2876,2876,0
Wojewodztwo Wielkopolskie,Powiat krotoszyński,M-W.Kobylin,3012023,8146,3228,4918
Wojewodztwo Wielkopolskie,Powiat krotoszyński,M-W.Koźmin Wielkopolski,3012033,13662,6726,6936
Wojewodztwo Wielkopolskie,Powiat krotoszyński,M-W.Krotoszyn,3012043,40799,29627,11172
Wojewodztwo Wielkopolskie,Powiat krotoszyński,G.Rozdrażew,3012052,5180,0,5180
Wojewodztwo Wielkopolskie,Powiat krotoszyński,M-W.Zduny,3012063,7277,4534,2743
Wojewodztwo Wielkopolskie,Powiat leszczyński,G.Krzemieniewo,3013012,8421,0,8421
Wojewodztwo Wielkopolskie,Powiat leszczyński,G.Lipno,3013022,6769,0,6769
Wojewodztwo Wielkopolskie,Powiat leszczyński,M-W.Osieczna,3013033,8880,2188,6692
Wojewodztwo Wielkopolskie,Powiat leszczyński,M-W.Rydzyna,3013043,8449,2653,5796
Wojewodztwo Wielkopolskie,Powiat leszczyński,G.Święciechowa,3013052,7466,0,7466
Wojewodztwo Wielkopolskie,Powiat leszczyński,G.Wijewo,3013062,3707,0,3707
Wojewodztwo Wielkopolskie,Powiat leszczyński,G.Włoszakowice,3013072,8915,0,8915
Wojewodztwo Wielkopolskie,Powiat międzychodzki,G.Chrzypsko Wielkie,3014012,3382,0,3382
Wojewodztwo Wielkopolskie,Powiat międzychodzki,G.Kwilcz,3014022,6261,0,6261
Wojewodztwo Wielkopolskie,Powiat międzychodzki,M-W.Międzychód,3014033,18623,10938,7685
Wojewodztwo Wielkopolskie,Powiat międzychodzki,M-W.Sieraków,3014043,8797,6133,2664
Wojewodztwo Wielkopolskie,Powiat nowotomyski,G.Kuślin,3015012,5625,0,5625
Wojewodztwo Wielkopolskie,Powiat nowotomyski,M-W.Lwówek,3015023,9337,3032,6305
Wojewodztwo Wielkopolskie,Powiat nowotomyski,G.Miedzichowo,3015032,3685,0,3685
Wojewodztwo Wielkopolskie,Powiat nowotomyski,M-W.Nowy Tomyśl,3015043,25245,15111,10134
Wojewodztwo Wielkopolskie,Powiat nowotomyski,M-W.Opalenica,3015053,16047,9417,6630
Wojewodztwo Wielkopolskie,Powiat nowotomyski,M-W.Zbąszyń,3015063,13565,7247,6318
Wojewodztwo Wielkopolskie,Powiat obornicki,M-W.Oborniki,3016013,32844,18336,14508
Wojewodztwo Wielkopolskie,Powiat obornicki,M-W.Rogoźno,3016023,18140,11361,6779
Wojewodztwo Wielkopolskie,Powiat obornicki,G.Ryczywół,3016032,7369,0,7369
Wojewodztwo Wielkopolskie,Powiat ostrowski,M.Ostrów Wielkopolski,3017011,72810,72810,0
Wojewodztwo Wielkopolskie,Powiat ostrowski,M-W.Nowe Skalmierzyce,3017023,15198,4935,10263
Wojewodztwo Wielkopolskie,Powiat ostrowski,M-W.Odolanów,3017033,14258,5105,9153
Wojewodztwo Wielkopolskie,Powiat ostrowski,G.Ostrów Wielkopolski,3017042,18545,0,18545
Wojewodztwo Wielkopolskie,Powiat ostrowski,G.Przygodzice,3017052,11854,0,11854
Wojewodztwo Wielkopolskie,Powiat ostrowski,M-W.Raszków,3017063,11693,2063,9630
Wojewodztwo Wielkopolskie,Powiat ostrowski,G.Sieroszewice,3017072,9680,0,9680
Wojewodztwo Wielkopolskie,Powiat ostrowski,G.Sośnie,3017082,6579,0,6579
Wojewodztwo Wielkopolskie,Powiat ostrzeszowski,G.Czajków,3018012,2540,0,2540
Wojewodztwo Wielkopolskie,Powiat ostrzeszowski,G.Doruchów,3018022,5228,0,5228
Wojewodztwo Wielkopolskie,Powiat ostrzeszowski,M-W.Grabów nad Prosną,3018033,7836,1997,5839
Wojewodztwo Wielkopolskie,Powiat ostrzeszowski,G.Kobyla Góra,3018042,6064,0,6064
Wojewodztwo Wielkopolskie,Powiat ostrzeszowski,G.Kraszewice,3018052,3651,0,3651
Wojewodztwo Wielkopolskie,Powiat ostrzeszowski,M-W.Mikstat,3018063,6175,1906,4269
Wojewodztwo Wielkopolskie,Powiat ostrzeszowski,M-W.Ostrzeszów,3018073,23901,14659,9242
Wojewodztwo Wielkopolskie,Powiat pilski,M.Piła,3019011,74775,74775,0
Wojewodztwo Wielkopolskie,Powiat pilski,G.Białośliwie,3019022,4989,0,4989
Wojewodztwo Wielkopolskie,Powiat pilski,G.Kaczory,3019032,7775,0,7775
Wojewodztwo Wielkopolskie,Powiat pilski,M-W.Łobżenica,3019043,9893,3105,6788
Wojewodztwo Wielkopolskie,Powiat pilski,G.Miasteczko Krajeńskie,3019052,3265,0,3265
Wojewodztwo Wielkopolskie,Powiat pilski,G.Szydłowo,3019062,8437,0,8437
Wojewodztwo Wielkopolskie,Powiat pilski,M-W.Ujście,3019073,8153,3895,4258
Wojewodztwo Wielkopolskie,Powiat pilski,M-W.Wyrzysk,3019083,14307,5279,9028
Wojewodztwo Wielkopolskie,Powiat pilski,M-W.Wysoka,3019093,6861,2741,4120
Wojewodztwo Wielkopolskie,Powiat pleszewski,G.Chocz,3020012,4772,0,4772
Wojewodztwo Wielkopolskie,Powiat pleszewski,G.Czermin,3020022,4882,0,4882
Wojewodztwo Wielkopolskie,Powiat pleszewski,G.Dobrzyca,3020032,8340,0,8340
Wojewodztwo Wielkopolskie,Powiat pleszewski,G.Gizałki,3020042,4671,0,4671
Wojewodztwo Wielkopolskie,Powiat pleszewski,G.Gołuchów,3020052,10248,0,10248
Wojewodztwo Wielkopolskie,Powiat pleszewski,M-W.Pleszew,3020063,30302,18024,12278
Wojewodztwo Wielkopolskie,Powiat poznański,M.Luboń,3021011,29832,29832,0
Wojewodztwo Wielkopolskie,Powiat poznański,M.Puszczykowo,3021021,9756,9756,0
Wojewodztwo Wielkopolskie,Powiat poznański,M-W.Buk,3021033,12230,6210,6020
Wojewodztwo Wielkopolskie,Powiat poznański,G.Czerwonak,3021042,26053,0,26053
Wojewodztwo Wielkopolskie,Powiat poznański,G.Dopiewo,3021052,18581,0,18581
Wojewodztwo Wielkopolskie,Powiat poznański,G.Kleszczewo,3021062,6230,0,6230
Wojewodztwo Wielkopolskie,Powiat poznański,G.Komorniki,3021072,20013,0,20013
Wojewodztwo Wielkopolskie,Powiat poznański,M-W.Kostrzyn,3021083,17117,9341,7776
Wojewodztwo Wielkopolskie,Powiat poznański,M-W.Kórnik,3021093,21092,7246,13846
Wojewodztwo Wielkopolskie,Powiat poznański,M-W.Mosina,3021103,27934,12769,15165
Wojewodztwo Wielkopolskie,Powiat poznański,M-W.Murowana Goślina,3021113,16433,10303,6130
Wojewodztwo Wielkopolskie,Powiat poznański,M-W.Pobiedziska,3021123,18176,8879,9297
Wojewodztwo Wielkopolskie,Powiat poznański,G.Rokietnica,3021132,12746,0,12746
Wojewodztwo Wielkopolskie,Powiat poznański,M-W.Stęszew,3021143,14484,5717,8767
Wojewodztwo Wielkopolskie,Powiat poznański,G.Suchy Las,3021152,14952,0,14952
Wojewodztwo Wielkopolskie,Powiat poznański,M-W.Swarzędz,3021163,44659,30928,13731
Wojewodztwo Wielkopolskie,Powiat poznański,G.Tarnowo Podgórne,3021172,21827,0,21827
Wojewodztwo Wielkopolskie,Powiat rawicki,M-W.Bojanowo,3022013,8949,2980,5969
Wojewodztwo Wielkopolskie,Powiat rawicki,M-W.Jutrosin,3022023,7108,1919,5189
Wojewodztwo Wielkopolskie,Powiat rawicki,M-W.Miejska Górka,3022033,9414,3220,6194
Wojewodztwo Wielkopolskie,Powiat rawicki,G.Pakosław,3022042,4749,0,4749
Wojewodztwo Wielkopolskie,Powiat rawicki,M-W.Rawicz,3022053,30180,21183,8997
Wojewodztwo Wielkopolskie,Powiat słupecki,M.Słupca,3023011,14256,14256,0
Wojewodztwo Wielkopolskie,Powiat słupecki,G.Lądek,3023022,5702,0,5702
Wojewodztwo Wielkopolskie,Powiat słupecki,G.Orchowo,3023032,3939,0,3939
Wojewodztwo Wielkopolskie,Powiat słupecki,G.Ostrowite,3023042,5120,0,5120
Wojewodztwo Wielkopolskie,Powiat słupecki,G.Powidz,3023052,2182,0,2182
Wojewodztwo Wielkopolskie,Powiat słupecki,G.Słupca,3023062,9344,0,9344
Wojewodztwo Wielkopolskie,Powiat słupecki,G.Strzałkowo,3023072,10090,0,10090
Wojewodztwo Wielkopolskie,Powiat słupecki,M-W.Zagórów,3023083,9172,3047,6125
Wojewodztwo Wielkopolskie,Powiat szamotulski,M.Obrzycko,3024011,2359,2359,0
Wojewodztwo Wielkopolskie,Powiat szamotulski,G.Duszniki,3024022,8485,0,8485
Wojewodztwo Wielkopolskie,Powiat szamotulski,G.Kaźmierz,3024032,7662,0,7662
Wojewodztwo Wielkopolskie,Powiat szamotulski,G.Obrzycko,3024042,4378,0,4378
Wojewodztwo Wielkopolskie,Powiat szamotulski,M-W.Ostroróg,3024053,4958,1980,2978
Wojewodztwo Wielkopolskie,Powiat szamotulski,M-W.Pniewy,3024063,12436,7904,4532
Wojewodztwo Wielkopolskie,Powiat szamotulski,M-W.Szamotuły,3024073,29358,19071,10287
Wojewodztwo Wielkopolskie,Powiat szamotulski,M-W.Wronki,3024083,18973,11611,7362
Wojewodztwo Wielkopolskie,Powiat średzki,G.Dominowo,3025012,2932,0,2932
Wojewodztwo Wielkopolskie,Powiat średzki,G.Krzykosy,3025022,6721,0,6721
Wojewodztwo Wielkopolskie,Powiat średzki,G.Nowe Miasto nad Wartą,3025032,9131,0,9131
Wojewodztwo Wielkopolskie,Powiat średzki,M-W.Środa Wielkopolska,3025043,30897,22325,8572
Wojewodztwo Wielkopolskie,Powiat średzki,G.Zaniemyśl,3025052,6529,0,6529
Wojewodztwo Wielkopolskie,Powiat śremski,G.Brodnica,3026012,4902,0,4902
Wojewodztwo Wielkopolskie,Powiat śremski,M-W.Dolsk,3026023,5860,1554,4306
Wojewodztwo Wielkopolskie,Powiat śremski,M-W.Książ Wielkopolski,3026033,8521,2783,5738
Wojewodztwo Wielkopolskie,Powiat śremski,M-W.Śrem,3026043,41082,30343,10739
Wojewodztwo Wielkopolskie,Powiat turecki,M.Turek,3027011,29059,29059,0
Wojewodztwo Wielkopolskie,Powiat turecki,G.Brudzew,3027022,6029,0,6029
Wojewodztwo Wielkopolskie,Powiat turecki,M-W.Dobra,3027033,6367,1480,4887
Wojewodztwo Wielkopolskie,Powiat turecki,G.Kawęczyn,3027042,5231,0,5231
Wojewodztwo Wielkopolskie,Powiat turecki,G.Malanów,3027052,6526,0,6526
Wojewodztwo Wielkopolskie,Powiat turecki,G.Przykona,3027062,4321,0,4321
Wojewodztwo Wielkopolskie,Powiat turecki,M-W.Tuliszków,3027073,10593,3421,7172
Wojewodztwo Wielkopolskie,Powiat turecki,G.Turek,3027082,8494,0,8494
Wojewodztwo Wielkopolskie,Powiat turecki,G.Władysławów,3027092,8091,0,8091
Wojewodztwo Wielkopolskie,Powiat wągrowiecki,M.Wągrowiec,3028011,25327,25327,0
Wojewodztwo Wielkopolskie,Powiat wągrowiecki,G.Damasławek,3028022,5626,0,5626
Wojewodztwo Wielkopolskie,Powiat wągrowiecki,M-W.Gołańcz,3028033,8518,3383,5135
Wojewodztwo Wielkopolskie,Powiat wągrowiecki,G.Mieścisko,3028042,6047,0,6047
Wojewodztwo Wielkopolskie,Powiat wągrowiecki,M-W.Skoki,3028053,9073,4036,5037
Wojewodztwo Wielkopolskie,Powiat wągrowiecki,G.Wapno,3028062,3116,0,3116
Wojewodztwo Wielkopolskie,Powiat wągrowiecki,G.Wągrowiec,3028072,11737,0,11737
Wojewodztwo Wielkopolskie,Powiat wolsztyński,G.Przemęt,3029012,13802,0,13802
Wojewodztwo Wielkopolskie,Powiat wolsztyński,G.Siedlec,3029022,12394,0,12394
Wojewodztwo Wielkopolskie,Powiat wolsztyński,M-W.Wolsztyn,3029033,30268,13723,16545
Wojewodztwo Wielkopolskie,Powiat wrzesiński,G.Kołaczkowo,3030012,6113,0,6113
Wojewodztwo Wielkopolskie,Powiat wrzesiński,M-W.Miłosław,3030023,10399,3641,6758
Wojewodztwo Wielkopolskie,Powiat wrzesiński,M-W.Nekla,3030033,7082,3543,3539
Wojewodztwo Wielkopolskie,Powiat wrzesiński,M-W.Pyzdry,3030043,7285,3272,4013
Wojewodztwo Wielkopolskie,Powiat wrzesiński,M-W.Września,3030053,45214,29526,15688
Wojewodztwo Wielkopolskie,Powiat złotowski,M.Złotów,3031011,18760,18760,0
Wojewodztwo Wielkopolskie,Powiat złotowski,M-W.Jastrowie,3031023,11791,8708,3083
Wojewodztwo Wielkopolskie,Powiat złotowski,M-W.Krajenka,3031033,7501,3800,3701
Wojewodztwo Wielkopolskie,Powiat złotowski,G.Lipka,3031042,5661,0,5661
Wojewodztwo Wielkopolskie,Powiat złotowski,M-W.Okonek,3031053,9024,4045,4979
Wojewodztwo Wielkopolskie,Powiat złotowski,G.Tarnówka,3031062,3133,0,3133
Wojewodztwo Wielkopolskie,Powiat złotowski,G.Zakrzewo,3031072,4922,0,4922
Wojewodztwo Wielkopolskie,Powiat złotowski,G.Złotów,3031082,9479,0,9479
Wojewodztwo Wielkopolskie,Powiat złotowski,m. Kalisz,3061,105386,105386,0
Wojewodztwo Wielkopolskie,Powiat złotowski,m. Konin,3062,78525,78525,0
Wojewodztwo Wielkopolskie,Powiat złotowski,m. Leszno,3063,64630,64630,0
Wojewodztwo Wielkopolskie,Powiat złotowski,m. Poznań,3064,554696,554696,0
Wojewodztwo Zachodniopomorskie,Powiat białogardzki,M.Białogard,3201011,24919,24919,0
Wojewodztwo Zachodniopomorskie,Powiat białogardzki,G.Białogard,3201022,8022,0,8022
Wojewodztwo Zachodniopomorskie,Powiat białogardzki,M-W.Karlino,3201033,9418,6036,3382
Wojewodztwo Zachodniopomorskie,Powiat białogardzki,M-W.Tychowo,3201043,7049,2497,4552
Wojewodztwo Zachodniopomorskie,Powiat choszczeński,G.Bierzwnik,3202012,4891,0,4891
Wojewodztwo Zachodniopomorskie,Powiat choszczeński,M-W.Choszczno,3202023,22515,15961,6554
Wojewodztwo Zachodniopomorskie,Powiat choszczeński,M-W.Drawno,3202033,5353,2404,2949
Wojewodztwo Zachodniopomorskie,Powiat choszczeński,G.Krzęcin,3202042,3879,0,3879
Wojewodztwo Zachodniopomorskie,Powiat choszczeński,M-W.Pełczyce,3202053,8112,2718,5394
Wojewodztwo Zachodniopomorskie,Powiat choszczeński,M-W.Recz,3202063,5795,3029,2766
Wojewodztwo Zachodniopomorskie,Powiat drawski,M-W.Czaplinek,3203013,12007,7179,4828
Wojewodztwo Zachodniopomorskie,Powiat drawski,M-W.Drawsko Pomorskie,3203023,16814,11895,4919
Wojewodztwo Zachodniopomorskie,Powiat drawski,M-W.Kalisz Pomorski,3203033,7317,4330,2987
Wojewodztwo Zachodniopomorskie,Powiat drawski,G.Ostrowice,3203042,2633,0,2633
Wojewodztwo Zachodniopomorskie,Powiat drawski,G.Wierzchowo,3203052,4428,0,4428
Wojewodztwo Zachodniopomorskie,Powiat drawski,M-W.Złocieniec,3203063,15733,13483,2250
Wojewodztwo Zachodniopomorskie,Powiat goleniowski,M-W.Goleniów,3204023,34967,22869,12098
Wojewodztwo Zachodniopomorskie,Powiat goleniowski,M-W.Maszewo,3204033,8625,3281,5344
Wojewodztwo Zachodniopomorskie,Powiat goleniowski,M-W.Nowogard,3204043,24964,17021,7943
Wojewodztwo Zachodniopomorskie,Powiat goleniowski,G.Osina,3204052,2971,0,2971
Wojewodztwo Zachodniopomorskie,Powiat goleniowski,G.Przybiernów,3204062,5271,0,5271
Wojewodztwo Zachodniopomorskie,Powiat goleniowski,G.Stepnica,3204072,4924,0,4924
Wojewodztwo Zachodniopomorskie,Powiat gryficki,G.Brojce,3205012,3837,0,3837
Wojewodztwo Zachodniopomorskie,Powiat gryficki,M-W.Gryfice,3205023,24087,17082,7005
Wojewodztwo Zachodniopomorskie,Powiat gryficki,G.Karnice,3205032,4210,0,4210
Wojewodztwo Zachodniopomorskie,Powiat gryficki,M-W.Płoty,3205043,9263,4114,5149
Wojewodztwo Zachodniopomorskie,Powiat gryficki,G.Rewal,3205072,3745,0,3745
Wojewodztwo Zachodniopomorskie,Powiat gryficki,M-W.Trzebiatów,3205083,16806,10238,6568
Wojewodztwo Zachodniopomorskie,Powiat gryfiński,G.Banie,3206012,6599,0,6599
Wojewodztwo Zachodniopomorskie,Powiat gryfiński,M-W.Cedynia,3206023,4478,1729,2749
Wojewodztwo Zachodniopomorskie,Powiat gryfiński,M-W.Chojna,3206033,14077,7356,6721
Wojewodztwo Zachodniopomorskie,Powiat gryfiński,M-W.Gryfino,3206043,32138,21700,10438
Wojewodztwo Zachodniopomorskie,Powiat gryfiński,M-W.Mieszkowice,3206053,7477,3606,3871
Wojewodztwo Zachodniopomorskie,Powiat gryfiński,M-W.Moryń,3206063,4433,1647,2786
Wojewodztwo Zachodniopomorskie,Powiat gryfiński,G.Stare Czarnowo,3206072,3850,0,3850
Wojewodztwo Zachodniopomorskie,Powiat gryfiński,M-W.Trzcińsko-Zdrój,3206083,5683,2485,3198
Wojewodztwo Zachodniopomorskie,Powiat gryfiński,G.Widuchowa,3206092,5611,0,5611
Wojewodztwo Zachodniopomorskie,Powiat kamieński,M-W.Dziwnów,3207013,4125,2867,1258
Wojewodztwo Zachodniopomorskie,Powiat kamieński,M-W.Golczewo,3207023,6075,2751,3324
Wojewodztwo Zachodniopomorskie,Powiat kamieński,M-W.Kamień Pomorski,3207033,14690,9302,5388
Wojewodztwo Zachodniopomorskie,Powiat kamieński,M-W.Międzyzdroje,3207043,6731,5625,1106
Wojewodztwo Zachodniopomorskie,Powiat kamieński,G.Świerzno,3207052,4358,0,4358
Wojewodztwo Zachodniopomorskie,Powiat kamieński,M-W.Wolin,3207063,12533,5014,7519
Wojewodztwo Zachodniopomorskie,Powiat kołobrzeski,M.Kołobrzeg,3208011,47129,47129,0
Wojewodztwo Zachodniopomorskie,Powiat kołobrzeski,G.Dygowo,3208022,5573,0,5573
Wojewodztwo Zachodniopomorskie,Powiat kołobrzeski,M-W.Gościno,3208033,5212,2468,2744
Wojewodztwo Zachodniopomorskie,Powiat kołobrzeski,G.Kołobrzeg,3208042,10015,0,10015
Wojewodztwo Zachodniopomorskie,Powiat kołobrzeski,G.Rymań,3208052,4139,0,4139
Wojewodztwo Zachodniopomorskie,Powiat kołobrzeski,G.Siemyśl,3208062,3671,0,3671
Wojewodztwo Zachodniopomorskie,Powiat kołobrzeski,G.Ustronie Morskie,3208072,3639,0,3639
Wojewodztwo Zachodniopomorskie,Powiat koszaliński,G.Będzino,3209012,8477,0,8477
Wojewodztwo Zachodniopomorskie,Powiat koszaliński,G.Biesiekierz,3209022,6040,0,6040
Wojewodztwo Zachodniopomorskie,Powiat koszaliński,M-W.Bobolice,3209033,9801,4345,5456
Wojewodztwo Zachodniopomorskie,Powiat koszaliński,G.Manowo,3209042,6762,0,6762
Wojewodztwo Zachodniopomorskie,Powiat koszaliński,G.Mielno,3209052,5104,0,5104
Wojewodztwo Zachodniopomorskie,Powiat koszaliński,M-W.Polanów,3209063,9190,3073,6117
Wojewodztwo Zachodniopomorskie,Powiat koszaliński,M-W.Sianów,3209073,13655,6690,6965
Wojewodztwo Zachodniopomorskie,Powiat koszaliński,G.Świeszyno,3209082,6410,0,6410
Wojewodztwo Zachodniopomorskie,Powiat myśliborski,M-W.Barlinek,3210013,19833,14353,5480
Wojewodztwo Zachodniopomorskie,Powiat myśliborski,G.Boleszkowice,3210022,2921,0,2921
Wojewodztwo Zachodniopomorskie,Powiat myśliborski,M-W.Dębno,3210033,21087,14171,6916
Wojewodztwo Zachodniopomorskie,Powiat myśliborski,M-W.Myślibórz,3210043,20848,11759,9089
Wojewodztwo Zachodniopomorskie,Powiat myśliborski,G.Nowogródek Pomorski,3210052,3411,0,3411
Wojewodztwo Zachodniopomorskie,Powiat policki,G.Dobra Szczecińska,3211012,16778,0,16778
Wojewodztwo Zachodniopomorskie,Powiat policki,G.Kołbaskowo,3211022,10809,0,10809
Wojewodztwo Zachodniopomorskie,Powiat policki,M-W.Nowe Warpno,3211033,1703,1253,450
Wojewodztwo Zachodniopomorskie,Powiat policki,M-W.Police,3211043,42057,34036,8021
Wojewodztwo Zachodniopomorskie,Powiat pyrzycki,G.Bielice,3212012,3143,0,3143
Wojewodztwo Zachodniopomorskie,Powiat pyrzycki,G.Kozielice,3212022,2622,0,2622
Wojewodztwo Zachodniopomorskie,Powiat pyrzycki,M-W.Lipiany,3212033,6187,4204,1983
Wojewodztwo Zachodniopomorskie,Powiat pyrzycki,G.Przelewice,3212042,5410,0,5410
Wojewodztwo Zachodniopomorskie,Powiat pyrzycki,M-W.Pyrzyce,3212053,19888,12925,6963
Wojewodztwo Zachodniopomorskie,Powiat pyrzycki,G.Warnice,3212062,3597,0,3597
Wojewodztwo Zachodniopomorskie,Powiat sławieński,M.Darłowo,3213011,14442,14442,0
Wojewodztwo Zachodniopomorskie,Powiat sławieński,M.Sławno,3213021,13163,13163,0
Wojewodztwo Zachodniopomorskie,Powiat sławieński,G.Darłowo,3213032,7928,0,7928
Wojewodztwo Zachodniopomorskie,Powiat sławieński,G.Malechowo,3213042,6622,0,6622
Wojewodztwo Zachodniopomorskie,Powiat sławieński,G.Postomino,3213052,7068,0,7068
Wojewodztwo Zachodniopomorskie,Powiat sławieński,G.Sławno,3213062,8904,0,8904
Wojewodztwo Zachodniopomorskie,Powiat stargardzki,M.Stargard Szczeciński,3214011,69966,69966,0
Wojewodztwo Zachodniopomorskie,Powiat stargardzki,M-W.Chociwel,3214023,6105,3287,2818
Wojewodztwo Zachodniopomorskie,Powiat stargardzki,M-W.Dobrzany,3214033,5122,2413,2709
Wojewodztwo Zachodniopomorskie,Powiat stargardzki,G.Dolice,3214042,8161,0,8161
Wojewodztwo Zachodniopomorskie,Powiat stargardzki,M-W.Ińsko,3214053,3596,2062,1534
Wojewodztwo Zachodniopomorskie,Powiat stargardzki,G.Kobylanka,3214062,4475,0,4475
Wojewodztwo Zachodniopomorskie,Powiat stargardzki,G.Marianowo,3214082,3222,0,3222
Wojewodztwo Zachodniopomorskie,Powiat stargardzki,G.Stara Dąbrowa,3214092,3662,0,3662
Wojewodztwo Zachodniopomorskie,Powiat stargardzki,G.Stargard Szczeciński,3214102,12231,0,12231
Wojewodztwo Zachodniopomorskie,Powiat stargardzki,M-W.Suchań,3214113,4360,1496,2864
Wojewodztwo Zachodniopomorskie,Powiat szczecinecki,M.Szczecinek,3215011,40787,40787,0
Wojewodztwo Zachodniopomorskie,Powiat szczecinecki,M-W.Barwice,3215023,8994,3840,5154
Wojewodztwo Zachodniopomorskie,Powiat szczecinecki,M-W.Biały Bór,3215033,5424,2261,3163
Wojewodztwo Zachodniopomorskie,Powiat szczecinecki,M-W.Borne Sulinowo,3215043,9754,4790,4964
Wojewodztwo Zachodniopomorskie,Powiat szczecinecki,G.Grzmiąca,3215052,5094,0,5094
Wojewodztwo Zachodniopomorskie,Powiat szczecinecki,G.Szczecinek,3215062,9512,0,9512
Wojewodztwo Zachodniopomorskie,Powiat świdwiński,M.Świdwin,3216011,15931,15931,0
Wojewodztwo Zachodniopomorskie,Powiat świdwiński,G.Brzeżno,3216022,2910,0,2910
Wojewodztwo Zachodniopomorskie,Powiat świdwiński,M-W.Połczyn-Zdrój,3216033,16166,8616,7550
Wojewodztwo Zachodniopomorskie,Powiat świdwiński,G.Rąbino,3216042,3892,0,3892
Wojewodztwo Zachodniopomorskie,Powiat świdwiński,G.Sławoborze,3216052,4278,0,4278
Wojewodztwo Zachodniopomorskie,Powiat świdwiński,G.Świdwin,3216062,6166,0,6166
Wojewodztwo Zachodniopomorskie,Powiat wałecki,M.Wałcz,3217011,26435,26435,0
Wojewodztwo Zachodniopomorskie,Powiat wałecki,M-W.Człopa,3217023,5134,2379,2755
Wojewodztwo Zachodniopomorskie,Powiat wałecki,M-W.Mirosławiec,3217033,5691,3095,2596
Wojewodztwo Zachodniopomorskie,Powiat wałecki,M-W.Tuczno,3217043,5107,1974,3133
Wojewodztwo Zachodniopomorskie,Powiat wałecki,G.Wałcz,3217052,12715,0,12715
Wojewodztwo Zachodniopomorskie,Powiat łobeski,M-W.Dobra,3218013,4537,2368,2169
Wojewodztwo Zachodniopomorskie,Powiat łobeski,M-W.Łobez,3218023,14518,10647,3871
Wojewodztwo Zachodniopomorskie,Powiat łobeski,G.Radowo Małe,3218032,3741,0,3741
Wojewodztwo Zachodniopomorskie,Powiat łobeski,M-W.Resko,3218043,8375,4459,3916
Wojewodztwo Zachodniopomorskie,Powiat łobeski,M-W.Węgorzyno,3218053,7312,2932,4380
Wojewodztwo Zachodniopomorskie,Powiat łobeski,m. Koszalin,3261,109248,109248,0
Wojewodztwo Zachodniopomorskie,Powiat łobeski,m. Szczecin,3262,410131,410131,0
Wojewodztwo Zachodniopomorskie,Powiat łobeski,m. Świnoujście,3263,41480,41480,0
